24320201
00000000000000000000001A1A1A000000000000000000000000000000000000000000000000000000000000000000000000
00000000001A1A1B1A1B1A1A701A1A1B1A1A1A00000000000000000000000000000000000000000000000000000000000000
000000001A1A88000000000000C2000000881A1A0000000000000000001A1A1B1A1A00000000000000000000000000000000
000000001A887A00000000A2000000000077881A00000000000000001A1A74B0791A1A000000000000000000000000000000
000000001B00008C00140000000000000000001B00000000000000001AB0000000001A000000000000000000000000000000
0000001A1A00C200001A33333333331A0000001A000000000000001A1A4040401A541A000000000000000000000000000000
0000001A8000000000332525532525330000001B1A1A1B1A1B1A1A1A8000000000001A1A1A1B1A1A1B1A1A1A000000000000
0000001A1A00000000332577007925330000001A1A8900770000881A000000C300001A88000000000000831A1A0000000000
1A1A1A1A1A00A200003325790077253300A27451000000740000005100131413000051000000A100000083831A1A00000000
1A8181811A13000000332525262525330000001A1A8900790000881A000000C300001A880000000000000000221A00000000
1A3333331A13000000332525252525330000C21B1A1A1B1A1B1A1A1A8000000000001A1A1A770000C1000000221A00000000
1A0505051A140000001A33333333331A0000001A001AC1A1C11A001A1A4040401A541A711A1A000000000000221A00000000
1A777E795100008C00000000000000130000001B001A7974771A00001A00B00000001A757A1A131313000000221A00000000
1A0000001A80790000000000000000000000801A001A1A1A1A1A00001A1A77B0741A1A79771A777914000000221A00000000
1A8001801A1A800000000000C20000A200801A1A0000000000000000001A1A1B1A1A1A1A1A1A000000A100001A1A00000000
1A1A1A1A1A1A1A1A1B1A1A511A1A1B1A1B1A1A1A00001A1A1A1A1A1A1A1A1A1A1A1A1A1A1A8000000000791A1A0000000000
0000000000000000001A8000801A00740000881A00001A8989898989898989891A1A1A1A8000A10000801A1A000000000000
0000000000000000001A0000002000000000001A1A1A1A3031313131313131321A1A1A1300000000801A1A00000000000000
0000000000000000001A79A2001A7700C100C17A1A8800050505050505050505881A7713131400001A1A0000000000000000
0000000000000000001B0000001B1A00002100001A0000C27414140000000000001A0000000000001A000000000000000000
0000000000000000001A0000001A230000B000005100008C00000000A2138C00005100C30000A0001A000000000000000000
0000000000000000001B00A2771B1A79000000881A00000000000000A21300A2001A000000831A1A1A1A1A1A1A1A1A1A1A00
0000000000000000001A0000001A1A1A2121211A1A8800C20014140000000000001A000000831A8800000000000000881A1A
0000000000000000001A80007541B177000000881A1A1A1A00777900001A1A00881A880083831A0000007A1300B000000023
00000000000000001A1A1A511A1A0000000000000000001A1A1B1A1B1A1A231A1A1A1A1B1A1A1A00A0000005000000001A1A
00000000000000001A770000000000000000B1000000A01A887900000000000000000000801A800000001A331A0079001A00
00000000000000001A79000000000013140000000500001A7979001400C20000C20000A00051000014053372330514001A00
00000000000000001A1A830000C300137400001A331A005100000014000000C200130000801A800074001A331A0000001A00
0000000000000000001A838383000000000005338733051A7777000000C20000701300771A1A1A000000000500B000001A00
0000000000000000001A1A1A83000000C300001A331A001A88770000000000C20000791A1A751A8300A00013770000831A00
00000000000000000000001A1A1A1A00000000000500791A1A1A1A1A1A747A00001A1A1A7A7A1A7400000000000083831A00
00000000000000000000000000001A1A1A1A1A1A1A1A1A1A000000001A1A1A1A1A1A001A79771A1A1A1A1A1A1A1A1A1A1A00
00000000000000000000000000000000000000001A1A0000000000001AD0D0D0D01A001A1A1A1A0000000000000000000000
000000000000000000000000000000000000000000000000000000001AD0D0D0D01A00000000000000000000000000000000
000000000000000000000000000000000000000000000000000000001AD0D0D0D01A00000000000000000000000000000000
000000000000000000000000000000000000000000000000000000001A1A1A1A1A1A00000000000000000000000000000000
0000000000000000000000000000000000000000000000000000000000000000000000000000000000000000000000000000
0000000000000000000000000000000000000000000000000000000000000000000000000000000000000000000000000000
0000000000000000000000000000000000000000000000000000000000000000000000000000000000000000000000000000
0000000000000000000000000000000000000000000000000000000000000000000000000000000000000000000000000000
0000000000000000000000000000000000000000000000000000000000000000000000000000000000000000000000000000
0000000000000000000001010101010000000000000000000000000000000000000000000000000000000000000000000000
0000000000000000000000000200000000000000000000000000000000000000000000000000000000000000000000000000
0000000000000000000000000000000000000000000000000003000000000000000000000000000000000000000000000000
0000000000000000000000000000000000000000000000000003000000000000000000000000000000000000000000000000
0000000000000000000000000E00000000000000000000000003000000000000000000000000000000000000000000000000
0000000000000000000000000000000000000000000004040400000000000000000000000000000000000000000000000000
0000000000000000000000000000000000000000000000000000000000000000000000060000000000000000000000000000
0000000000000000000000000000000000000000000000000000000000000000000005060600000000000000000000000000
0000000000000000000000000000000000000000000000000000000000000000000000060600000000000000000000000000
0000000000000000000000000000000000000000000000000000000000000000000000000000000000000000000000000000
0000000000000000000000000000080808000000000000000000000000000000000000000000000000000000000000000000
0000000000000000000000000000000000000000000000000000000000000000000000000000000000000000000000000000
0000000000000000000000000000000000000000000000000000000000000000000000000000000000000000000000000000
0000000000000000000000000000000000000000000000000000000000000000000000000000000000000000000000000000
0000000000000000000000000000000000000000000000000000000000000000000000000000000000000000000000000000
0000000000000000000000000000070000000000000000000000000000000000000000000000000000000000000000000000
0000000000000000000000000000000000000000000000000000000000000000000000000000000000000000000000000000
0000000000000000000000000000000000000000000000000000000000000000000000000000000000000000000000000000
000000000000000000000000000000000000000000000000000000000000000000000000000000000000000000000000000D
0000000000000000000000000000000000000000000000000000000000000900000000000000000000000000000000000000
0000000000000000000000000000000000000000000000000000000000000000000000000000000000000008000000000000
0000000000000000000000000000000000000000000000000000000000000000000000000000000000000800080000000000
0000000000000000000000000000000000000000000000000000000000000000000000000000000000000008000000000000
0000000000000000000000000000000000000000000000000000000000000000000000000000000000000000000000000000
000000000000000000000000000000000000000000000000000000000000000000000000000C000000000000000000000000
0000000000000000000000000000000000000000000000000000000000000000000000000C0C0B0000000000000000000000
00000000000000000000000000000000000000000000000000000000000A0A0A0A0000000C0C000000000000000000000000
0000000000000000000000000000000000000000000000000000000000000000000000000000000000000000000000000000
0000000000000000000000000000000000000000000000000000000000000000000000000000000000000000000000000000
0000000000000000000000000000000000000000000000000000000000000000000000000000000000000000000000000000
0000000000000000000000000000000000000000000000000000000000000000000000000000000000000000000000000000
