272A0016
00000000000000000000000000000000001A1A1A1A1A1A1A1A1A00000000000000000000000000000000
00000000000000000000000000000000001A141375037014131A00000000000000000000000000000000
00000000000000000000000000000000001A130000000000141A00000000000000000000000000000000
00000000000000000000000000000000001A7700008C0000791A00000000000000000000000000000000
00000000000000000000000000000000001A1A88000000881A1A00000000000000000000000000000000
0000000000000000000000000000000000001A1A8000801A1A0000000000000000000000000000000000
000000000000000000000000000000000000001A1A541A1A000000000000000000000000000000000000
0000000000000000000000000000000000001A1A8000801A1A0000000000000000000000000000000000
0000000000000000000000000000000000001A14000000131A0000000000000000000000000000000000
0000000000000000000000000000000000001A7A008C00741A000000000000001A1A1A1B1A1A1B1A1A1A
0000000000000000000000000000001A1A1A1A00A000A0001A1A1A1A000000001A80890000007988881A
0000000000000000000000000000001A88000000000000000083831A000000001A79000000C30077881B
00001A1A1A1B1A1A1B1A1A1B1A1A1A1A77000025255025250079831A1A1B1A1A1A00008C00000000001A
00001A838300000000C200A10000741B000000257A0077250000001B8800777441A0000000801A00001A
00001A8300000077220000000000801A0000C22575007925C200001A0000007941B3A200001F1A71A01B
00001B7900B100000000001B79A10054008C002525262525138C005400008C001A40401A001F1BD3721A
00001A88000000C2770005050000801A00000014141314131413001A0000A000A0000000001F1A74791B
1A1A1A1A1A541A1A1B1A33331A7A1A1B00000000000000000000001B880000000000008C00801A41411A
1A81300588008800771A89891A1A1A1A83790000B28CB2000077891A1A1A1A1A147900C3000000A3001A
1A81310500A00000771A1A1A1A00001A83830000000000007A89881A7770741A141374000000007A831B
1A8131050079000000791A1B1A1A001A1A1A1A1B1A541A1B1A1A1A1A7A79791A1A1A1A1B1A050583831A
1A813105001BA0001B0000C3891A1A1717171817170017191717171A1A1A1A1A000000001A33331A1A1A
1A81320500000000C3000000001A171788000000000000881770171719171717000000001A81811A0000
1A1A1A8970741400000000B3751A171379008C0000C20077177A740000141417000000001A1A1A1A0000
00001A1A1A1A1A1B1A511A1B1A1A1714790074831717431717830000B000141719171717171700000000
00000000001A14790000A374831A1714A20083831780B38917000000000000187A79D000731700000000
00000000001A0000A2000000831A171700000000177400791700008C00A1005477137977751700000000
00000000001B0000008CA000001B001900A28CA000008CA01900A1147917171719171717171700000000
00000000001A7A83000000008C1A00170000000017000000170000147717000000000000000000000000
00000000001A75838377C200001A00178800000043C30000000000B00019000000000000000000000000
00000000001A1A1A1B1A1A00C01A181717177A7917797780178000008817000000000000000000000000
00000000001A830000005400801A77797A17171917171917171719171717000000000000000000000000
00000000001B7400C2001A411A1A1A1A1A1A1A1A18C3A2B3180000000000000000000000000000000000
00000000001AA000000000B01A807913147A751A18757A79180000000000000000000000000000000000
00000000001A1A00228C00A354007AD300007C2318181818180000000000000000000000000000000000
0000000000001A0000A000001A000000D300771A00000000000000000000000000000000000000000000
0000000000001B7A7714797A1A7779771A1A1A1A00000000000000000000000000000000000000000000
0000000000001A89771479881A8377881A00000000000000000000000000000000000000000000000000
0000000000001A1A1A1A1B1A1A1A1A1A1A00000000000000000000000000000000000000000000000000
000000000000000000000000000000000000000000000000000000000000000000000000000000000000
000000000000000000000000000000000000000000000000000000000000000000000000000000000000
000000000000000000000000000000000000000000000000000000000000000000000000000000000000
000000000000000000000000000000000000000000000000000000000000000000000000000000000000
000000000000000000000000000000000000000000000000000000000000000000000000000000000000
000000000000000000000000000000000000000000000000000000000000000000000000000000000000
000000000000000000000000000000000000000000000000000000000000000000000000000000000000
000000000000000000000000000000000000000000000000000000000000000000000000000000000000
000000000000000000000000000000000000000000000000000000000000000000000000000000000000
000000000000000000000000000000000000000000000000000000000000000000000000000000000000
000000000000000000000000000000000000000000000000000000000000000000000000000000000000
000000000000000000000000000000000000000000000000000000000000000000000000000000000000
0000000000000000000000000000000000000000000B0000000000000000000000000000000000000000
000000000000000000000000000000000000000000000000000000000000000000000000000000000000
000000000000000000000000000000000000000000000000000000000000000000000000000000000000
0000000000000000000000000000000A00000000000C0000000000000000000000000000000000000000
000000000000000000000000000000000000000000000000000000000000000000000000000000000000
000000000000000000000000000000000000000000000000000000000000000000000000000000000000
000000000000000000000000000000000000000000000000000000000001000000000000000000000000
000000000000000000000000000000000000000000000000000000000202020000000000000000000000
000000000000000000000000000000000000000000090000000000000202020000000000000000000000
000000000000000000000000000000000000000000000000000000000000000000000000000000000000
000000000000000000000000000000000000000000000000000000000000000000000000000000000000
000000000000000000000000000000000000000000000000000000000000000000000000000000000000
000000000000000000000000000000000000000000000000000000000000000000000000000000000000
000000000000000000000000000000000000000000000000000000000000000000000000000000000000
000000000000000000000000000000000000000000000000000000000000000000000000000000000000
000000000000000000000000000000000000000000000000000000000000000000000000000000000000
000000000000000000000000000000000000000000000000000000000000000000000000000000000000
000000000000000000000000000000000000000000000000030000000000000000000000000000000000
000000000000000000000000000000000000000000000000000000000000000000000000000000000000
000000000000000000000000000008080800060000040400000000000000000000000000000000000000
000000000000000000000000000007000000060000000000000000000000000000000000000000000000
000000000000000000000000000000000000000000000000000000000000000000000000000000000000
000000000000000000000000000000000000000500000000000000000000000000000000000000000000
000000000000000000000000000000000000000000000000000000000000000000000000000000000000
000000000000000000000000000000000000000000000000000000000000000000000000000000000000
000000000000000000000000000000000000000000000000000000000000000000000000000000000000
000000000000000000000000000000000000000000000000000000000000000000000000000000000000
