2C0E0000
1515152525262525151515000000
1515152500760025151515000000
1515152500000025151515000000
1515151525502515151515000000
1515218000000080211515000000
1515212000000020211515000000
15152122A274A222211515000000
1515212000000020211515000000
1515218000000080211515000000
1515151615541516151515000000
1515808300000083801515000000
1515830000A20000831515000000
151583A2000000A2831515000000
1515174218511842171515000000
1515830000000000831515000000
1515830000000000831515000000
1515808300000083801515000000
1515151615541516151515000000
1515838300000083831515000000
1515830000000000831515151515
1515210000A20000891515891515
1515220076007400001600701615
1515210000A20000891515891515
1515830000000000831515151515
1515838300000083831515000000
1515151615541516151515000000
1515151380008083301515000000
15151A1AA200A283311515000000
1515328300000083311515000000
1516318300000083311615000000
1515318383008383321515000000
151531838376831A1A1515000000
1515308380008013151515000000
1515151615541515151515000000
1515158380008083151515000000
1515151A0000001A151515000000
1515151B00A2001B151515000000
1515151A8300831A151515000000
1515158383008383151515000000
1515151515541515151515000000
1515151380008013151515000000
1515151400010014151515000000
1515151300000014151515000000
151515151E1D1C15151515000000
0000000000010000000000000000
0000000000000000000000000000
0000000000000000000000000000
0000000000000000000000000000
0000000000000000000000000000
0000000000000000000000000000
0000000000000000000000000000
0000000000000000000000000000
0000000000000000000000000000
0000000000000000000000000000
0000000000000000000000000000
0000000000000000000000000000
0000000000000000000000000000
0000000000000000000000000000
0000000000000000000000000000
0000000000000000000000000000
0000000000000000000000000000
0000000000000000000000000000
0000000000000000000000000000
0000000000000000000000000000
0000000000000000000000000000
0000000000000000000203000000
0000000000000000000000000000
0000000000000000000000000000
0000000000000000000000000000
0000000000000000000000000000
0000000000000000000000000000
0000000000000000000000000000
0000000000000000000000000000
0000000000000000000000000000
0000000000000000000000000000
0000000000000000000000000000
0000000000000000000000000000
0000000000000000000000000000
0000000000000000000000000000
0000000000000000000000000000
0000000000000000000000000000
0000000000000000000000000000
0000000000000000000000000000
0000000000000000000000000000
0000000000000000000000000000
0000000000000000000000000000
0000000000000000000000000000
0000000000000000000000000000
