21360201
000000000000000000000000000000001A1A1A1B1A1A1A00000000000000000000000000000000000000000000000000000000000000
000000000000000000000000000000001A80030083831A0000000000000000000000001A1A1B1A1A1A1A1A1B1A1A1A1A1B1A1A1A0000
000000000000000000000000000000001B00008C00831B0000000000000000000000001A80D27377801A8875881A89C100C2891A0000
000000000000000000000000000000001A77000000701A00000000000000000000001A1A74790077141A798C000000008C00001B0000
000000000000000000000000000000001A1A1A511A411A00000000000000000000001A2120008C79141B00B0001A89790077891A0000
000000000000000000000000000000001A1300C000001A00000000000000000000001B202100A179131A0000831A1A1A001A1A1A0000
000000000000000000000000000000001B74008C00B01B00000000000000000000001A14A1000014141A00001A101010541010100000
000000000000000000000000000000001A88000088141A0000000000001A1A1A1B1A1A1400008C000000B01A1A108079007780100000
000000000000000000000000000000001A1A1A541A1A1A1A1A1A1A1A1A1A7A7977751A1400A10000771A1A1A101080008C0080100000
0000001A1A1B1A1A1B1A1A1B1A1A1B1A1A8800000000A31314881A813305B2C2A3B11B807A771313131A1A10108000A2008010100000
0000001A13891414A3000000A30000881A7900C30000000000001A813305A3C2A3C21A1A1A1A1A1A1A1A101080000000801010000000
1A1A1A1B89B37900A3001414141400791B14001B008C001B00001B1A1A1A1B1A1A1A1A1010102C101010108000B20080101000000000
1A7A791A130000008C8314757A1400001A0000000020000000001A1A7A79770000881A10887900008810740000008010101010101010
1A707500140000008383141A1314A3005400008C2021208C00A354758C77798C0000540000008CA2005400008C001010797A7433D310
1A1A1A1A1300C1000000B341740000001A0000C11320750000001A1A0505050505051A108877A274881000C100A31400797A7033D310
0000001B000000008C00001B00008C001B00001B148C001B00001A1A3333333333331A1010102C101010790000771010777A7433D310
0000001A7783000000000000000000001A0000000000000000B11A1A8989898989891A00000000000010890089831010101010101010
0000001A7A838374A2202200C17783881A88790000B1137700881A1A1A1A1A1A1A1A1A00000000000010105410101010000000000000
0000001A1A1B1A1A541A1A1B1A1A1B1A1A1A1A1A1414131B1A1A1A00000000000000000000000000001A1A001A1A1A1A000000000000
0000001A80000000008C0000001474130000801A7777001A00000000000000000000000000000000001A890000C3891A000000000000
0000001B79000000050505C2000000000000C31B7979721B00000000000000000000000000000000001A00008C00001A000000000000
0000001A1400A21A3333331A00A3001A1A541A1A137A0023000000000000000000000000001A1A1A1B1A00A300A3001A1B1A1A1A0000
0000001A14000533818181330500001A83C2771A1400D21A000000000000000000000000001A8877000000007A0000000079881A0000
0000001B778C053381818133058C0041B300801A138C001A000000000000000000000000001B140000001A4040401A00A200001B0000
0000001A20000533818181330500141A778C005400A0A11B000000000000000000000000001A000071000000750000000000001A0000
0000001A2000001A3333331A00007141B200801A0000831A000000000000000000000000001B001A401A00C18CC2001A401A001B0000
0000001B0000B10005050500B100001A8300791A8975891A000000000000000000000000001A7477B000000000001300B279001A0000
0000001A80000000778C79000000881A1A1B1A1A1A1B1A1A000000000000000000000000001A838300000000D30000000083831A0000
0000001A1A1B1A1A1B1A1A1B1A1A1B1A0000000000000000000000000000000000000000001A1A1A1B1A25255025251A1B1A1A1A0000
000000000000000000000000000000000000000000000000000000000000000000000000000000000000257700782500000000000000
000000000000000000000000000000000000000000000000000000000000000000000000000000000000257800772500000000000000
000000000000000000000000000000000000000000000000000000000000000000000000000000000000250000002500000000000000
000000000000000000000000000000000000000000000000000000000000000000000000000000000000252526252500000000000000
000000000000000000000000000000000000000000000000000000000000000000000000000000000000000000000000000000000000
000000000000000000000000000000000000000000000000000000000000000000000000000000000000000000000000000000000000
000000000000000000000000000000000000000000000000000000000000000000000000000000000000000000000000000000000000
000000000000000000000000000000000000000000000000000000000000000000000000000000000000000000000000000000000000
000000000000000000000000000000000000000000000000000000000000000000000000000000000000000000000000000000000000
000000000000000000000000000000000000000000000000000000000000000000000000000000000000000000000000000000000000
000000000000000000000000000000000000000000000000000000000000000000000000000000000000000000000000000000000000
000000000000000000000000000000000000000000000000000000000000000000000000000000000000000000000000000000000000
000000000000000000000000000000000000000000000000000000000000000000000000000000000000000000000000000000000000
000000000000000000000000000000000000000000000000000000000000000000000000000000000000000000000000000000000000
000000000000000000000000000000000000000000000000000000000000000000000000000000000000000000000000000000000000
000000000000000000000000000000000000000000000000000000000009090909090000000000000000000000000000000000000000
000505000000000000000003030000000000000000000000000000000008000000000000000000000000000000000000000000000000
000505050400000000000000020000000000000000000000000001000008000000000000000000000000000000000000000000000000
000000000000000000000000000000000000000000000000000000000008000000000000000000000000000000000A0B000000000000
000000000000000000000000000000000000000000000000000000000000000000000000000000000000000000000000000000000000
000000000000000000000000000000000000000000000000000000000000000000000000000000000000000000000000000000000000
000000000000000000000000000000000000000000000000000000000000000000000000000000000000000C00000000000000000000
000000000000000000000000000000000000000007070000000000000000000000000000000000000000000000000000000000000000
000000000000000000000000000000000000000000000000000000000000000000000000000000000000000000000000000000000000
000000000000000000000000000000000000000000000000000000000000000000000000000000000000000000000000000000000000
000000000000000000000000000000000000000000000006000000000000000000000000000000000000000000000000000000000000
000000000000000000000000000000000000000000000000000000000000000000000000000000000000000000000000000000000000
000000000000000000000000000000000000000000000000000000000000000000000000000000000000000000000000000000000000
000000000000000000000000000000000000000000000000000000000000000000000000000000000000000000000000000000000000
000000000000000000000000000000000000000000000000000000000000000000000000000000000000000000000000000000000000
000000000000000000000000000000000000000000000000000000000000000000000000000000000000000000000000000000000000
000000000000000000000000000000000000000000000000000000000000000000000000000000000000000000000000000000000000
000000000000000000000000000000000000000000000000000000000000000000000000000000000000000000000000000000000000
000000000000000000000000000000000000000000000000000000000000000000000000000000000000000000000000000000000000
000000000000000000000000000000000000000000000000000000000000000000000000000000000000000000000000000000000000
000000000000000000000000000000000000000000000000000000000000000000000000000000000000000000000000000000000000
00000000000000000000000000000000000000000000000000000000000000000000000000000000000000000D000000000000000000
