2D3C1103
00000000001A1A1C1D1E1A1A1A1A1B1A1B1A1A2525252500000000000000000000000000000000000000000000000000000000000000000000000000
00000000001B00003800001A880000000000882579742500000000000000000000000000000000000000000000000000000000000000000000000000
00000000001BA0003800B1510000C100C10000547A7A2600000000000000000000000000000000000000000000000000000000000000000000000000
00000000001B00003800001A880000000000882577742500000000000000000000000000000000000000000000000000000000000000000000000000
00000000001B7A143800001B1A1A1B1A1B1A1A2525252500000000000000000000000000000000000000000000000000000000000000000000000000
000000001A1A74143800C21B000000000000000000000000000000000000000000000000000000000000000000000000000000000000000000000000
000000001A1414143800001B000000000000000000000000000000000000000000000000000000000000000000000000000000000000000000000000
000000001A1A00003800B11B000000000000000000000000000000000000000000000000000000000000000000000000000000000000000000000000
00000000001B00003800791B000000000000000000000000000000000000000000000000000000000000000000000000000000000000000000000000
00000000001BC2003813131A000000000000000000000000000000000000000000000000000000000000000000000000000000000000000000000000
00000000001B00003800131A1A0000000000000000000000000000000000000000000000000000000000000000000000000000000000000000000000
00000000001B00A0380000131A0000000000000000000000000000000000000000000000000000000000000000000000000000000000000000000000
00000000001B88003800881B1A0000000000000000000000000000000000000000000000000000000000000000000000000000000000000000000000
00000000001A1A1A511A1A1A000000000000000000000000000000000000000000000000000000000000000000000000000000000000000000000000
00000000001A88007500881A000000000000000000000000000000000000000000000000000000000000000000000000000000000000000000000000
00000000001A05050505051A000000000000000000000000000000000000000000000000000000000000000000000000000000000000000000000000
000000001A1A33333333331A1A0000000000000000000000000000000000000000000000000000000000000000000000000000000000000000000000
00001A1B1A887900007700881A1B1A000000000000000000000000000000000000000000000000000000000000000000000000000000000000000000
001A1A80000000002200000000891A1A0000000000000000000000000000000000000000000000000000000000000000000000000000000000000000
001B8000C0000000000000C00000891B0000000000000000000000001719182D18191700000000000000000000000000000000000000000000000000
1A1A00C075831A0000001A000000001A1A0000000000000000001717178900000089171717000000001A1A1A1A000000000000000000000000000000
1A79000083831A7AB2771A8300C000881B00000000000000001717890000007400000089171700001A1A83831A1A1A1A0000001A1A1A1A0000000000
1B7900A01A1A1A0000001A1A1A00A0791A17181918191817171783C200B079207A0000008317171A1A000000C100001A1A1B1A1A7B001A1B1A1A0000
1A00D1A0A07900001400007400A000791A178800000080178083830000002020200000C28317793305771B00001B001A8000000000000000001A1A1A
1B00220000B20014131400B20000220000517900A3000051000000B000007A20790000000051003305A20000000000510000B000771400B00074791A
1A000000007400001400007900A000771A1788000000801780000000222200C2002222000017773305000000C100001A80000000131300000083831B
1B77C0001A1A1A0000001A1A1A00A0771A1718191819181717178300C2770000007700008317171A1A791B00001B001B1A1A800000000000A100001A
1A77000000831A77B27A1A75830000881B0000000000000000171788000000B000C2C28817171A81330500000000001A001A1A00A11313130000001B
1A1A00A0C0001A0000001A008300001A1A0000000000000000001717170000000000171717001A81330500A20013141A00001B80000079140000001A
001B890000000000000000000000801B000000000000000000000000171819181918170000001A813305000000747A1A00001A1A00000000C200831B
001A1A89000000002200C0C000801A1A00000000000000000000000017A0C3C3C3A2170000001A1A1A1A1A1A511A1A1A001A1A1A131A00000083831A
00001A1B1A887777007979881A1B1A0000000000000000000000000017A2B1B1B1A2170000000000001A88000000881A001A777A711A1A1A511A1A1A
000000001A1A1A1A511A1A1A1A00000000000000000000000000000017777A717A751700000000001A1A00000000001A001A777A1A1A800000801A1A
000000001A838300A20079141A1A1A1A0000000000000000000000001717171717171700000000001B00A3A3A3001A1A001A1A1A1A7900000000801A
000000001A837700000000741B757A1A0000000000000000001A1A1A1A1A1A1A0000000000001A1B1A0000A300001B0000001A1A7700222200C01A1A
000000001A830000C20079131A797A1A0000000000000000001AD1D17079771A000000001A1B1A000000141314001A1A00001A0000A2220000001A00
000000001B0000001A1A1B1A1A1A1A1A00000000001A1A1A1A1A1A1A1A1A1A1A1A1A1A1B1A797900C20074138300001A00001A0000000000001A1A00
000000001AA2007741797900001A000000000000001A7979000000000000A277881A880000001B00001B00000000B01B00001A88000000881A1A0000
000000001A7900001A00001B001A1A1A000000000023757A00001B00001B00797951000000000000007A00C20000001A00001A1A1A511A1A1A000000
000000001B8300C2510000000000791A00000000001A777700000000A2000079771A0000B0001B00B01B00000083831B00001A80007400801A000000
000000001A8300001A75D20000D2791A00000000001A1A1A1A1A1A00001B0077881A830000000000000000001A1A1A1A00001B00000000001B000000
000000001A8377004100001B00007A23000000000000000000001A1A0000001A1A1A8379791A1B1A1A1B1A1A1A00000000001A83000100831A000000
000000001A1A1A1A1A7777000000771A00000000000000000000001A1A801A1A001A1A1B1A1A0000000000000000000000001A1A1A1A1A1A1A000000
000000000000001A1A1A1B1A0000771A0000000000000000000000001A1A1A0000000000000000000000000000000000000000000000000000000000
00000000000000000000001A1A1B1A1A0000000000000000000000000000000000000000000000000000000000000000000000000000000000000000
000000000000000000000000000000000000000000000000000000000000000000000000000000000000000000000000000000000000000000000000
000000000000000000000000000000000000000000000000000000000000000000000000000000000000000000000000000000000000000000000000
000000000000000000000000000000000000000000000D00000000000000000000000000000000000000000000000000000000000000000000000000
000000000000000000000000000000000000000000000000000000000000000000000000000000000000000000000000000000000000000000000000
000000000000000000000000000000000000000000000000000000000000000000000000000000000000000000000000000000000000000000000000
000000000000000000000000000000000000000000000000000000000000000000000000000000000000000000000000000000000000000000000000
000000000000000000000000000000000000000000000000000000000000000000000000000000000000000000000000000000000000000000000000
000000000000000000000000000000000000000000000000000000000000000000000000000000000000000000000000000000000000000000000000
000000000000000000000000000000000000000000000000000000000000000000000000000000000000000000000000000000000000000000000000
000000000000000000000000000000000000000000000000000000000000000000000000000000000000000000000000000000000000000000000000
000000000000000000000000000000000000000000000000000000000000000000000000000000000000000000000000000000000000000000000000
000000000000000000000000000000000000000000000000000000000000000000000000000000000000000000000000000000000000000000000000
000000000000000000000000000000000000000000000000000000000000000000000000000000000000000000000000000000000000000000000000
000000000000000000000000000000000000000000000000000000000000000000000000000000000000000000000000000000000000000000000000
000000000000000000000000000000000000000000000000000000000000000000000000000000000000000000000000000000000000000000000000
000000000000000000000000000000000000000000000000000000000000000000000000000000000000000000000000000000000000000000000000
0000000000000C0C0C0C0C00000000000000000000000000000000000000000000000000000000000000000000000000000000000000000000000000
000000000000000000000000000000000000000000000000000000000000000000000000000000000000000000000000000000000000000000000000
000000000000000000000000000000000000000000000000000000000000000000000000000000000000000000000000000000000000000000000000
000000000000000000000000000000000000000000000000000000000000000700000000000000000000000000000000000000000000000000000000
000000000000000000000000000000000000000000000000000000000000000000000000000000000000000000000000000000000000000000000000
000000000000000000000000000000000000000000000000000000000000000000000000000000000000000000000000000000000000000000000000
000000000000000000000000000000000000000000000000000000000000000000000000000000000000000000000000000000000000000000000000
000000000000000000000000000000000000000000000000000000000000000000000000000000030000000000000000000000000000000000000000
000000000000000000000000000000000000000000000000000000000000000000000000000000030000000000000000000000000000000000000000
000000000000000000000000000000000000000000000000000000000000000000000000000000030000000000000000000000000000000000000000
000000000000000000000000000000000000000000000000000000000000000000000000000000000000000000000000000000000000000000000000
000000000000000000000000000000000000000000000000000000000000000000000000000000000000000000000000000000000000000000000000
000000000000000000000000000000000000000000000000000000000000000000000000000000000000000000000000000000000000000000000000
000000000000000000000000000000000000000000000000000000000008080808080000000000000000000000000000000000000000000000000000
000000000000000000000000000000000000000000000000000000000000000000000000000000000000000000000000000000000100000000000000
000000000000000000000000000000000000000000000000000000000000000000000000000000000000000000000000000002020200000000000000
000000000000000000000000000000000000000000000000000000000000000000000000000000000000000000000000000002020000000000000000
000000000000000000000000000000000000000000000000000000000000000000000000000000000000000000000000000000000000000000000000
000000000000000000000000090A0A000000000000000000000000000000000000000000000000000000000000000000000000000000000000000000
000000000000000000000000000A0A000000000000000000000000000000000000000000000000000000000000000000000000000000000000000000
000000000000000000000000000000000000000000000000000005050000000000000000000000000000000000000000000000000000000000000000
000000000000000000000000000000000000000000000000000000000004000000000000000000000000000000000000000000000000000000000000
000000000000000000000000000000000000000000060000000000000000000000000000000000000000000000000000000000000000000000000000
000000000000000000000000000000000000000000000000000000000004000000000000000000000000000000000000000000000000000000000000
000000000000000000000000000000000000000000000000000000000000000000000000000000000000000000000000000000000000000000000000
0000000000000000000000000000000B0000000000000000000000000004000000000000000000000000000000000000000000000000000000000000
000000000000000000000000000000000000000000000000000000000000000000000000000000000000000000000000000000000000000000000000
000000000000000000000000000000000000000000000000000000000000000000000000000000000000000000000000000000000000000000000000
000000000000000000000000000000000000000000000000000000000000000000000000000000000000000000000000000000000000000000000000
