10070000
10101010101010
10102526251010
10102500251010
101A1A001A1A10
101A8075801A10
101B83A2831B10
101A8300831A10
101A1A501A1A10
101A8376831A10
101B838C831B10
101A8000801A10
101A1A001A1A10
10102501251010
10102551251010
10102525251010
10101010101010
00000000000000
00000002000000
00000000000000
00000000000000
00000000000000
00000000000000
00000000000000
00000000000000
00000000000000
00000000000000
00000000000000
00000000000000
00000000000000
00000001000000
00000000000000
00000000000000
