09050000
1010101010
1025502510
1025002510
101A001A10
101A001A10
101A001A10
101A011A10
101A1A1A10
1010101010
0000000000
0000020000
0000010000
0000000000
0000000000
0000000000
0000000000
0000000000
0000000000
