0F0F0000
171717171717171917171717171717
173131313131313131313131313117
1731D1D1D1D1D1B2B2B2B2B2B23117
1731D1171817292A2B171817B23117
1731D1188000000000008018B23117
1731D0170000008C00000017B23117
1731D02B0000000000000029B23117
1931D02A008C0001008C002AC23119
1731A129000000000000002BC23117
1731A1170000008C00000017C23117
1731A1188000000000008018C23117
1731A11718172B2A29171817C23117
1731A1A1A1A1A1A1C2C2C2C2C23117
173131313131313131313131313117
171717171717171917171717171717
000000000000000000000000000000
000000000000000000000000000000
000000000000000000000000000000
000000020202020202020202000000
000000020000000000000002000000
000000020001010101010002000000
000000020001000000010002000000
000000020001000000010002000000
000000020001000000010002000000
000000020001010101010002000000
000000020000000000000002000000
000000020202020202020202000000
000000000000000000000000000000
000000000000000000000000000000
000000000000000000000000000000
