09090000
101010101010101010
101A1B1A1A25252510
101B00000000512510
101A001A1A25252510
101A001A1010101010
102501251010101010
102550251010101010
102525251010101010
101010101010101010
000000000000000000
000000000000000000
000000000001030000
000000000000000000
000000000000000000
000000000000000000
000002000000000000
000000000000000000
000000000000000000
