0F070000
10101010101010
10102525251010
10102551251010
10102500251010
10101A001A1010
101A1A8C1A1A10
101A8000801A10
101A1B521B1A10
101A8000801A10
101A1A8C1A1A10
10101A001A1010
10102501251010
10102551251010
10102525251010
10101010101010
00000000000000
00000000000000
00000002000000
00000003000000
00000000000000
00000000000000
00000000000000
00000000000000
00000000000000
00000000000000
00000000000000
00000000000000
00000001000000
00000000000000
00000000000000
