3C150200
000000000000000025252625250000000000000000
000000000000000025000000250000000000000000
000000000000000025000000250000000000000000
000000000000000025250025250000000000000000
000000000000000000175317000000000000000000
000000000017171817170017171817170000000000
000000000017800000000000000080170000000000
0000000000197AB10000000000B375190000000000
000000000017800000000000000080170000000000
17171817191717171800001F171717170000000000
177617000000000019000022170000000000000000
17C11700000017171800001F171717000000000000
18C118007E00178917000000178917000000000000
17C117007900177451000000517417000000000000
17761700000017A21780008017A217000000000000
171718171918174317175017174317181800000000
000000001832800000000000000080301800000000
00000000173100B10505050505C200311700000000
000000001931000005333333050000311900000000
00000000173100C005338133050000311700000000
000000001830807805331833050080321800000000
000000001818171717171717170017181800000000
0000000000000000000000001A511A000000000000
00000000001A1A1A1A1A1B1A1A001A1A1A1A1A1A00
00000000001A2189C1003800890000530000801A00
00000000001A2270000038000000001A0000001A00
00000000001A2189000038007883831A00007A1A00
00000000001A1A1A1A0038001A1A1A1A00A0131A00
00001A1A1A1A1A1A80003800801A1A1B008C131A00
001A1A731A1A1A1A1A0038001A1A1A1A00B0141A00
001A8000861A00A14000380040A3001A0000131A00
001A000000548CB14000380040B38C540000001A00
001A0000001A74A14000380040A3741A8600801A00
001A00B2001A1A1A1A0038001A1A1A1A1A721A1A00
001A008C001B1A1A80003800801A1A1A1A1A1A0000
001A00A2001A1A1A1A0038001A1A1A1A0000000000
001A8300001A1383000038000000001A0000000000
001A8300001A141400003800001478230000000000
001A80000053B100000038000014131A0000000000
001A1A1A1A1A1A1A1A0038001A1A1A1A0000000000
00000000000000001B0038001B0000000000000000
00001A1A1A1A1A1A1A0038001A1A1A1A0000000000
00001A8383830000000038001313141A0000000000
00001A830000008C000038007414141A0000000000
00001A000000000000003800C313141A0000000000
00001A1A541A1A1A1A1A1B1A1A1A1A1A0000000000
00001A1300001A800000000000801A000000000000
00001A1300001B000000A10000001A000000000000
00001A14B2001A00B300000000001A1A1A00000000
00001A0000001A0000001A00000000A31A00000000
00001A008C001B008C001A008C0000801B00000000
00001A00A2001A00A0001A00000000B31A00000000
00001A000000B10000831A0000001A1A1A00000000
00001A830000000000831A0000001A000000000000
00001A808383832120211A8000801A000000000000
00001A1A1B1A1A1A1A1A1A1A541A1A1A2828282800
00000000001A1F201F1A00000000891A2889892828
00000000001A22798C5200000100001B0000797128
00000000001A1F201F1A74000000891A2889892828
00000000001A1A1B1A1A1B1E1D1C1B1A2828282800
000000000000000000000D00000000000000000000
000000000000000000000000000000000000000000
000000000000000000000000000000000000000000
000000000000000000000000000000000000000000
000000000000000000000C00000000000000000000
000000000000000000000000000000000000000000
000000000000000000000000000000000000000000
000000000000000000000000000000000000000000
000000000000000000000000000000000000000000
000000000000000000000000000000000000000000
00000B000000000908000000000000000000000000
00000B000000000000000000000000000000000000
00000B000A00000000000000000000000000000000
00000B000000000000000000000000000000000000
00000B000000000000000000000000000000000000
000000000000000000000000000000000000000000
000000000000000000000000000000000000000000
000000000000000000000000000000000000000000
000000000000000000000000000000000000000000
000000000000000000000000000000000000000000
000000000000000000000000000000000000000000
000000000000000000000000000000000000000000
000000000000000000000000000000000000000000
000000000000000000000000000000000000000000
000000000000000000000000000000050000000000
000000000000000000000000000000000000000000
000000000000000000000000000000000000000000
000000000000000000000000000000000000000000
000000000000000000000000000000000000000000
000000000000000000000000000000000000000000
000000000000000000000000000000000000000000
000000000000000000000000000000000000000000
000000000000000000000000000000000000000000
000000000000000000000000000000000000000000
000000000000000000000000000000000000000000
000000000000000000000000000000000000000000
000000000000000000000000000000000000000000
000000000000000000000000000000040000000000
000000000006000000000000000000000000000000
000000000000000000000000000000000000000000
000000000000000000000000000000000000000000
000000000000000000000000000000000000000000
000000000000000000000000000000000000000000
000000000000000000000000000000000000000000
000000000000000000000000000000000000000000
000000000000000000000000000000000000000000
000000000000000000000000000000000000000000
000000000000000000000000000000000000000000
000000000000000000000000000000000000000000
000000000000000000000000000000000000000000
000000000000000000000000000000000000000000
000000000000000000000000000000000000000000
000000000000000000000000000000000000000000
000000000000000000000000000000000000000000
000000000000000000000000000000000000000000
000000000000000000000000000000000000000000
000000000000000000000000000000000000000000
000000000000000000000000000000020300000000
000000000000000000000000000000000000000000
000000000000000000000000000000000000000000
