3F400000
10102C1010101010101010101010101010101010102C102C102C101010101C1D1E1010101010101010102C101010171719171710102C1010101010102C101000
1083830000000000000000A200000083838010303131310031313132100000380000108075008010800000008010170000001710303131313131313131311000
2C838C00A2831414B100008C000000A300005100A38C0000C18CA1005100B33800701077797E005000C18CC100510000B2000051A38C00B3B300A2008C312C00
1083A10083131413138300B2007414148380103231313131310031311000003800001080710080108000A00080101700000017108383740000000000A2321000
1083000010101010101010511010101010101010101010101051101010000038000010101010101010102C10101017008C001710101010102C10101051101000
10000000101515151515150015151615151515151515161515001515100000380000101717171817171917171817170000001717171817171717102100211000
1000B1001015888988158300000000000088158800000000000083151000003800001017801414838376000000000000B2000000000083838017102000201000
1000000010150000741583A000A38CB30000520000B38CB1008C831610000038000010170000000000A200000000000000000000A10000008317102100211000
2C7A8C005100008C00158383750000007A8815888313141400001415100000380000101700000000000000831314801753178000000000008317103200301000
101400001015B2000015148383151515151516151515151500A014151000003800001017000000171750171717171718531817171717000013172C318C312C00
101400A010150000A21513831415893333337D3333338915000013151000C338A1005100A38C83178000801780838317531783838017008C1417103000321000
10130000101500C2141513131415000000000000000000520000831510000038000010170000141883A0761800B20000000000B200180000141810217C211000
108000801015001414151313131500A10000B10000A200158889881510000038000010170000141776000017000000008C000000001700007817102000201000
1010511010160014131515151515000000000000000000151515151510000038000010170000761700B0004300A30025002500A1004300000017102100211000
10800080101500A21315890000000000001516150000000000008915100000380000101900B20019838C0043008C00252625008C004300B20019101051101000
107400001015000013153300A100008C00881688008C0000A200331510000038000010170000001783B0004300A30025252500A1004300000017108900891000
1000B00010150000B215330000000000781515157400000000003315100000380000101700001417830000170000000075000000001700000017108300831000
100000001015A200001533000000158815B1C2B1158815000000331510000038000010170000131878D0751800C000008C0000C0001883000018100000831000
2CA28CA05100008C00520000B300161615C27EC215161600B20000005100B338B1005100A38C14170000001780000000000000008017148C00171000B0831000
1000B1001015A200001533000000158815B1C2B11588150000003315100000380000101700007817172D17171717174343431717171714000017100000001000
10000000101514A20015330000000000751515157800000000003315100000380000101700000017171717178383760000000000801776000017100000001000
102100211015130000153300A000008C00881688008C0000A3003315100000380000101800B200000080172D00D100A18CA100B1005000A1000051A38CA32C00
1020C022101513C20015890000000000001516150000000000000015100000380000101700000000000017177678838383740083801700000017100000001000
102100211015140000151515151500000000000000000015151500151080003800801017000000000000171717171717191717171717000000171000B2001000
1080728010157500000000A2881500A00000B30000A3001517175117171718381817171751171700000000007813138383830000000000000017100000741000
100505051015830000008C008915000000000000000000151789008900001743170000000086170000A30000008C0000A300008C000000000017100505051000
10303132101589B1000000A388158933333377333333891517000000000000000000000000001780141314147600000000000076838314138017103333331000
1081818110151515151500151515151515151615151515151900B1A10000008C000000A0B0001917171717181717171719171717171817171717108181811000
10102C101010101010105110101010101010101010102C101700A1002021007500212000A0001710102C10101010101010101010102C1010101010102C101000
10000000000070000000000000000000750000000000748017000000212121222121210000001780000000000000007000000000000000000079000000001000
1E00B000000000000000B00000000000000000000000C300181700000021B2B0B22100000017180000B20000000000C30000000000B2000000000000B2001C00
1D38383838383838383838383838383838383838383838383843008C7522C370C122748C00433838383838383838383838383838383838383838383838381D00
1C00A200000000000000A20000000000000000000000A200181700000021B2B2B22100000017180000A20000000000A10000000000A2000000000000A2001E00
10000000000076000000000000000000790000000000008017000000212121222121210000141780000000000000007500000000000000000074000000001000
101051101010101010105110101010102C101010101051101700A1002021007400212000A2001710105110101010102C10101010105110101010101051101000
10800080101A1A1B1A1A001A1B1A1A1A1B1A1A1A1A1A001A1983B1A10000008C000000A2B200191A1A001A1A1A1A1A1B1A1A1A1A1A001A1A1A1A108000801000
10830000101A838383000000000000000000741A801A001A1783000000000000000000000013171A83000000000000000000000000000000831A108300001000
1013B000101A838C0000B00000A300008C0000A10000B01A1783000083831743171314000013171A13B000008C00A3C0A1008C0000B00083831B10138C001000
10130000101A80A20000001A801A8300C00083838300001A1717511717171738171717175117171A1414838300001A801A83838300000083141A101300001000
1014A200101A1A541A1A1A1A1A1A1A1A541A1A1A1B1A1A1A1A1A001A108000380080101A001A1B1A1A1A1A1A1A1A1A1A1A1A1A1A1A541A1A1A1A100000001000
10000000101A80000000838383831A0000001A13141383000000001A100000380000101A00000083831A8083830000000089000000000083801A2C78B2002C00
2C758C00510000A30000000083831BA28CA21B13000000000000A01B100000380000101A00000000831A0000000000A300C100A100000000831A100000741000
1000A000101A80000000000000001A77B2741A83000000000000001A100000380000101A0000A000001A000000000013131413B100000000001A100000831000
10140000101A1A41411A1A00B0001A1A411A1A00B0001A1A41411A1A100000380000101B74008C0000540000A38C001377717913008CA100000051008C141000
1013B200101AB1A0A0811A00000000000000000000001A81A0A0B31A100000380000101A8300A000001A0000000000B31313131300000000001A100000131000
10140000101A008C00A141008C00A300B200A1008C0041A3008C771A2C74A338A1762C1A83140000B01A0000000000A300C300A100000000831A101400741000
10800080101A790074201A83141483800080138383141A200000751A100000380000101A14130000141A8083837400008383838300767583801A1083A2001000
10105110101A1A541A1A1A1A1A1A1A1A541A1A1A1A1A1A1A1A541A1A100000380000101A141300B0131A1A1A1A1B1A1A1A1A1A1A1A1B1A1A1A1A2C8300002C00
10800080101A8300831414141413138000808383141413838300831A100000380000101A14B20013131A313131313131321A303131313131321A1000A2001000
10830014101A83A20000007813130000A20000831375000000A2831A100000380000101A13000014141A311414137514141A838383760083831A100000761000
1083A014101A0000000000000000000000000000000000000000001A100000380000101AB2000013831A311413000000001A8383A100B100001A100000141000
10140076101A0000001A401A0000000000000000001A401A0000001A100000380000101A0000A200831A3114008CB3B100510000008C0000000051008C131000
2C838C005400B38CA3408140008500007300008500408140A18CB1005100A338B100510000008C00741B317700001314001A0000C1000000001A1000B2131000
1083A000101A0000001A401A0000000000000000001A401A0000001A100000380000101A0000A200001A31000000A3A1001A000000000000001A100000831000
101F0076101A00000000000000B20000D20000B2000000000000001A100000380000101A00000000831A3100008C0000131A050514740005051A108000801000
101F0083101A0000141414000000000000000000000000000000001A100000380000101A83000000831A311400000000131A333314131333331A101051101000
1020A0832C1A8083831313138000808314838000808383131414801A100000380000101A83000083831A301313000000801A803314141333801A108000801000
101F0013101A1A1A1A1A1A1A1A001A1A1A1A1A001A1A1A1A1A1A1A1A100000380000101A1A1A001A1A1A1A1A1A001A1A1A1A1A1A1A1A1A1A1A1A100000001000
101F0013101010102C1010101051101010101051101010102C101010100000380000101010105110101010101054101010102C1010101010101010008C001000
10830074108000000000000000000000000000000000007683838380100000380000108383000000781383830000000000000000761313000080100000001010
2C138C0051000000A300B300008CC1001413838C00A10000B100A1005100B338A1782C1383008CA1000000B1008C00A1A100B10000008C000000510004005010
10138383108078212020217600008383131314141413838300000080100000380000101383830000000000000000781414838383740000000080100000001010
10102C101010101010101010102C101010101010101010101010101010101E1D1C10101010101010102C1010101010101010101010102C10101010102C101000
00000000000000000000000000000000000000000000000000000000000000000000000000000000000000000000000000000000000000000000000000000000
00000000000000000000000000000000000000000000000F00000000000000000000000000000000000000000000000000000000000000000000000000000000
00000000000000000000000000000000000000000000000000000000000000000000000000000000000000000000000000000000000000000000000000000000
00000000000000000000000000000000000000000000000000000000000000000000000000000000000000000000000000000000000000000000000000000000
00000000000000000000000000000000000000000000000000000000000000000000000000000000000000000000000000000000000000000000000000000000
00000000000000000000000000000000000000000000000000000000000000000000000000000000000000000000000000000000000000000000000000000000
00000000000000000000000000000000000000000000000000000000000000000000000000000000000000000000000000000000000000000000000000000000
00000000000000000000000000000000000000000000000000000000000000000000000000000000000000000000000000000000000000000000000000000000
00000000000000000000000000000000000000000000000000000000000000000000000000000000000000000000000004000000000000000000000000000000
00000000000000000000000000000000000000000000000000000000000000000000000000000000000000000000000003000000000000000000000000000000
000000000000000000000000000000000000000000000000000000000000000000000A0000000000000000000000000002000000000000000000000000000000
00000000000000000000000000000000000000000000000000000000000000000000000000000000000000000000000000000000000000000000000000000000
00000000000000000000000000000000000000000000000000000000000000000000000000000000000000000000000000000000000000000000000000000000
00000000000000000000000000000000000000000000000000000000000000000000000000000000000000000000000000000000000000000000000000000000
00000000000000000000000000000000000000000000000000000000000000000000000000000000000000000000000001000000000000000000000000000000
00000000000000000000000000000000000000000000000000000000000000000000000000000000000000000000000000000000000000000000000000000000
00000000000000000000000000000000000E0E0E0000000000000000000000000000000000000000000000000000000000000000000000000000000000000000
000000000000000000000000000000000E1010100E00000000000000000000000000000000000000000000000000000000000000000000000000000000000000
000000000000000000000000000000000E1000100E000000000000000000000000000A0000000000000000000000000000000000000000000000000000000000
000000000000000000000000000000000E1010100E00000000000000000000000000000000000000000500000000000000000000000000000000000000000000
00000000000000000000000000000000000E0E0E0000000000000000000000000000000000000000000000000000000000000000000000000000000000000000
00000000000000000000000000000000000000000000000000000000000000000000000000000000000000060000000000000000000000000000000000000000
00000000000000000000000000000000000000000000000000000000000000000000000000000000000000000000000000000000000000000000000000000000
00000000000000000000000000000000000000000000000000000000000000000000000000000000000000000000000000000000000000000000000000000000
00000C0000000000000000000000000000000000000000000000000000000000000000000A000000000000000000000000000000000000000000000000000000
00000000000000000000000000000000000000000000000000000000000000000000000000000000000000000000000000000000000000000000000000000000
00000000000000000000000000000000000000000000000000000000000000000000000000000000000000000000000000000000000000000000000000000000
00000000000000000000000000000000000000000000000000000000000000000000000000000000000000000000000000000000000000000000000000000000
00000000000000000000000000000000000000000000000000000000000000000000000000000000000000000000000000000000000000000000000000000000
00000000000000000000000000000000000000000000000000000000000B0B0B0B0B000000000000000000000000000000000000000000000000000000000000
00000000000000000000000000000000000000000000000000000000000B0000000B000000000000000000000000000000000000000000000000000000000000
00000000000000000000000000000000000000000000000000000000000B0000000B000000000000000000000000000000000000000000000000000000000000
00000000000000000000000000000000000000000000000000000000000B0000000B000000000000000000000000000000000000000000000000000000000000
00000000000000000000000000000000000000000000000000000000000B0B0B0B0B000000000000000000000000000000000000000000000000000000000000
00000900000000000000090000000000000000000000090000000000000000000000000000000000000000000000000000000000000000000000000000000000
00000000000000000000000000000000000000000000000000000000000000000000000000000000000000000000000000000000000000000000000000000000
00000000000000000000000000000000000000000000000000000000000000000000000000000000000000000000000000000000000000000000000000000000
00000000000000000000000000000000000000000000000000000000000000000000000000000000000000000000000000000000000000000000000000000000
00000000000000000000000000000000000000000000000000000900000000000000000000000000000000000000000000000000000000000000000000000000
00000000000000000000000000000000000000000000000000000000000000000000000000000000000000000000000000000000000000000000000000000000
00000000000000000000000000000000000000000000000000000000000000000000000000000000000000000000000000000000000000000000000000000000
00000000000000000000000000000000000000000000000000000000000000000000000000000000000000000000000000000000000000000000000000000000
00000000000000000000000000000000000000000000000000000000000000000000000000000000000000000000000000070000000000000000000000000000
0000000000000000000000000000000000000000000000000000000000000000000000000000000000000000000000000D0D0D00000000000000000000000000
00000000000000000000000000000000000000000000000000000000000000000000000000000000000000000000000000000000000000000000000000000000
00000000000000000000000000000000000000000000000000000000000000000000000000000000000000000000000000000000000000000000000000000000
00000000000000000000000000000000000000000000000000000000000000000000000000000000000000000000000000000000000000000000000000000000
00000000000000000000000000000000000000000000000000000000000000000000000000000000000000000000000000000000000000000000000000000000
00000000000000000000000000000000000000000000000000000000000000000000000000000000000000000000000000000000000000000000000000000000
00000000000000000000000000000000000000000000000000000000000000000000000000000000000000000000000000000000000000000000000000000000
00000000000000000000000000000000000000000000000000000000000000000000000000000000000000000000000000000000000000000000000000000000
00000000000000000000000000000000000000000000000000000000000000000000000000000000000000000000000000000000000000000000000000000000
00000000000000000000000000000000000000000000000000000000090000000000000000000000000000000000000000000000000000000000000000000000
00000000000000000000000000000000000000000000000000000000000000000000000000000000000000000000000000000000000000000000000000000000
00000000000000000000000000000000000000000000000000000000000000000000000000000000000000000000000000000000000000000000000000000000
00000000000000000000000000000000000000000000000000000000000000000000000000000000000000000000000000000000000000000000000000000000
00000000000000000000000000000000000000000000000000000000000000000000000000000000000000000000000000000000000000000000000000000000
00000000000000000000000000000000000000000000000000000000000000000000000000000000000000000000000000000000000000000000000000000000
00000000000000000000000000000000000000000000000000000000000000000000000000000000000000000000000000000000000000000000000000000000
00000000000000000000000000000000000000000000000000000000000000000000000000000000000000000000000000000000000000000000000000000000
00000000000000000000000000000000000000000000000000000000090000000000000000000000000000000000000000000000000000000000000000001100
00000000000000000000000000000000000000000000000000000000000000000000000000000000000000000000000000000000000000000000000000000000
00000000000000000000000000000000000000000000000000000000000000000000000000000000000000000000000000000000000000000000000000000000
