2C210F09
00000000001A1A1B1A1A1A1B1A1A00000000000000000000000000000000000000
0000001A1A1A85858500B27A771A00000000000000000000000000000000000000
0000001A8133050000000013141A00000000000000000000000000000000000000
0000001A331A8C00A200008C001B00000000000000000000000000000000000000
00001A1A0500000000000000001A00000000000000000000000000000000000000
00001A7400A200000000C200881A00000000000000000000000000000000000000
00001A80000077801A1A1A501A1A1A1A0000000000000000000000000000000000
1A1A1A1A501A1A1A1A8800000000881A0000000000000000000000000000000000
1A83830000000070410000C30000001B0000000000000000000000000000000000
1A8300008C000074410000008C00771A0000000000000000000000000000000000
1B79000000001A1A1A00C30000001A1A0000000000000000000000000000000000
1A80770179801A751B790000C300221A0000000000000000000000000000000000
1A1A1A1B1A1A1A771A1A88000000221A0000000000001A1A1A1A1A1A1A00000000
0000000000001A71791A1A1A511A1A1A1B1A1A1A00001A89898989891A1A1B1A1A
0000000000001A1A1A1A1480008020200000791A1A1A1A30313131321A7479881A
0000000000000000001A0000000000000000881A80790005050505051A00D3001A
0000000000000000001A00B200A00000C200745077778CA0008C007A1A00007723
0000000000000000001B00001B00001B0000881A8079000000A3757A1A00D3771A
0000000000000000001A00000000B2000077141A1A1A1B1A1A531A1A1A0000001A
0000000000000000001A7700000000000013131A0000001A800000801A8379881A
0000000000000000001A1A1A1B1A1A1B1A1A1B1A1A1A1A1A77A200001A1A1B1A1A
0000000000000000001A79797A1A8800000000791AB2B21B008C0000131A000000
0000000000000000001A77741A1A0000A20083741A41411AC300A200131A000000
0000000000000000001A1A221A7A00000000831A1A000020000000007A1B000000
0000000000000000001A8800000000200000001A89000000C18C00C3001A000000
00000000000000001A1A0000B200C120C10000537400A20000008383831A000000
00000000000000001A7700001B000000771A1A1A1A1B1A511A1B1A1A1A1A000000
00000000000000001BB20000C10000771A1A001717191700171718171817170000
00000000000000001A7900001A1A1B1A1A0000178000000017C2A2C2A2C2170000
00000000000000001A8800881A000000000000197700A07A171718171817170000
00000000000000001A1A511A1A1A1A1A1A1A1717000000001700797A0000170000
00000000000000001A80000533811AD2D2D2171700A38C17170013140072190000
00000000000000001B77000533811AD2D2D217177000B3000000747700002D0000
0000000000001A1A1A778C0533811AD2D2D2198879007400000000000088170000
0000000000001A140000C1001A1A1A414141171717191719171917191717170000
0000000000001A14000000001A71747A00001A0000000000000000000000000000
0000000000001A1A404040001A79777A1A1A1A0000000000000000000000000000
000000000000001AA0A08C001A1314131A00000000000000000000000000000000
000000000000001B0079A0791A7AD2771A00000000000000000000000000000000
000000000000001A004040401A1A1A1A1A25252525000000000000000000000000
000000000000001A00C1B2C11A8000748025777925000000000000000000000000
000000000000001B00758C705000008C0052757A26000000000000000000000000
000000000000001A880000801A8000778025777925000000000000000000000000
000000000000001A1A1B1A1A1A1A1A1A1A25252525000000000000000000000000
000000000000000000000000000000000000000000000000000000000000000000
000000000000000000000000000000000000000000000000000000000000000000
000000000000000000000000000000000000000000000000000000000000000000
000000000000000000000000000000000000000000000000000000000000000000
000000000000000000000000000000000000000000000000000000000000000000
000000000000000000000000000000000000000000000000000000000000000000
000000000000000000000000000000000000000000000000000000000000000000
000000000000000000000000000000000000000000000000000000000000000000
000000000000000000000000000000000000000000000000000000000000000000
000000000000000000000000000000000000000000000000000000000000000000
000000000000000000000000000000000000000000000000000000000000000000
000000000000000201000000000000000000000000000000000000000000000000
000000000000000000000000000000000000000000000000000000000000000000
000000000000000000000000000000000000000000000000000000000000000000
000000000000000000000000000000000000000000000000000000000000000000
000000000000000000000000000000000000000000000000030000000400000000
000000000000000000000000000000000000000000000000030000000400000006
000000000000000000000000000000000000000000000000030000000400000000
000000000000000000000000000000000000000000000000001200000000000000
000000000000000000000000000000000000000000000000000000000000000000
000000000000000000000000000000000000000000000000000000000000000000
000000000000000000000D0D0D0000000000000000000000000000000000000000
000000000000000000000D0D000000000000000000000000000000000000000000
00000000000000000000000C000000000000000000000000000000000000000000
000000000000000000000000000000000000000000000000000000000000000000
000000000000000000000000000000000000000500000000000000000000000000
000000000000000000000000000000000000000000000000000000000000000000
000000000000000000000000000000000000000000000000000000000000000000
000000000000000000000000000000000000000000000000000000000000000000
000000000000000000000000000000000000000000000000000909090909000000
0000000000000000000000000000000000000000000000000B0000000000000000
000000000000000000000000000000000000000000000000000800000000000000
0000000000000000000000000000000000000000000000070008000000000A0000
000000000000000000000000000000000000000000000007000800000000000000
000000000000000000000000000000000000000000000000000000000000000000
000000000000000000000000000000000000000000000000000000000000000000
000000000000000000000000001111110000000000000000000000000000000000
000000000000000000000000000010000000000000000000000000000000000000
000000000000000000000000000000000000000000000000000000000000000000
000000000000000000000000000F0F0F0000000000000000000000000000000000
00000000000000000000000000000E000000000000000000000000000000000000
00000000000000000000000000000E000000000013000000000000000000000000
00000000000000000000000000000E000000000000000000000000000000000000
000000000000000000000000000000000000000000000000000000000000000000
