10050000
1010101010
1025252510
1025512510
1025002510
101A001A10
101A8C1A10
101AA21A10
101A001A10
101A501A10
101A001A10
101A8C1A10
101A001A10
1025012510
1025512510
1025252510
1010101010
0000000000
0000000000
0000020000
0000030000
0000000000
0000000000
0000000000
0000000000
0000000000
0000000000
0000000000
0000000000
0000000000
0000010000
0000000000
0000000000
