0C0D0000
10101010101010101010101010
101A1A1A1B1A1A1A1010101010
101A80000000801A1010101010
101A1A000000001A1A25252510
101A23008C0000530000512510
101A1A000000001A1A25252510
101A80000000801A1010101010
101A1A1A001A1A1A1010101010
10101025012510101010101010
10101025512510101010101010
10101025252510101010101010
10101010101010101010101010
00000000000000000000000000
00000000000000000000000000
00000000000000000000000000
00000000000000000000000000
00000400000000030005020000
00000000000000000000000000
00000000000000000000000000
00000000000000000000000000
00000000000000000000000000
00000000010000000000000000
00000000000000000000000000
00000000000000000000000000
