322E0703
000000000000000000000000000000001A1A1A1A1A00000000000000000000000000000000000000000000000000
00000000001A1A1A1A1B1A1A1B1A1A1A1A7979771A00000000000000000000000000000000000000000000000000
00000000001A893305000300000533891A7A7A751A00000000000000000000000000000000000000000000000000
00000000001A8933050000001F0533891A1A1B1A1B1A1B1A1A1A1A1A000000000000000000000000000000000000
00000000001A893305008C00000533891A880000000079771A74771A000000000000000000000000000000000000
00000000001A1A1A8874797700881A1A1A0000C2000079771A797923000000000000000000000000000000000000
000000000000001A1314131A541A1A7A130000001A0000001A00001A000000000000000000000000000000000000
000000000000001A1A1A1A1A001A1A0000C28C0040A08C0023D0731A000000000000000000000000000000000000
000000000000001A747A138000801B000000000040A000001A001A1A1A1A1A1A1A1A1A1A1B1A1A1B1A1A00000000
000000000000001A797A130000001A1A1A1A1A541A1B1A1A1A1A1AA2A2A2A2A2A2A25400797977777C1A00000000
000000000000001A14131300A0000083831A8000000083831A1A1AB3B3B3B3B3B3B31A00B3A1A1B3701A00000000
000000000000001A0000A10022000000831A0000000000001A1A1A404040404040401A1A1A1A1A1A1A1A1A1A0000
000000000000001B000000000000000000540000B30000891A8900000000000000801A800000C2000000881A0000
000000000000001A838300000000C377791A00000000000054008C00008C00008C005100A02222000000891A0000
000000000000001A1A1A1B541A1A4040401A838300B300891A8900000000000000801A00007777008C0074230000
000000000000000000001A001A1A74777A1A7175000000141A1A1A404040404040401A008C0000C30000891A0000
1A1A1A1A1A1B1A1A1A1A1A7477000000001A1A1A1B1A1A1A1A1A1AB3B3B3B3B3B3B31A0000002020007A1A1A0000
1A838300000000801A8383797700000000001AC3000000881A1A1AA2A2A2A2A2A2A21A80B3007979001A1A000000
1A83C200000000001A8300000022000000001AC3000000771A1A1A1A1A1A1A1A1A1A1A1A1A541A1A1A1A00000000
1B00008C00008CA11B0000000000000000001BC38C0000051A00000000000000001A887900000014881A00000000
1A8800C2130000A11A0000220000008C00831A7000001A331A00000000000000001A7700008C0000001A00000000
1A1A1A541A0000A11A00000000007A7583831A7A740533811A00000000000000001A0000B3000000001A1A1A1A1A
1A8800001A1B1A1A1A1A1B1A1A1A1A1B1A1A1A4040401A1A1A00000000000000001B00001B00001BB3790533811A
1BA0000000791314000000001A00000000001AB1B3001A000000000000000000001A75770000000000770533811A
1A77778C007914008C00D3722300000000001A1A1A1A1A000000000000000000001A7A790000A200008C0533811A
1A1A137700C30000000000831A00000000000000000000000000000000000000001A1A1A33331A00A0C2001A1A1A
001A141300000000801A1A1A1A000000000000000000000000000000000000000000001AD0D133000000891A0000
001A1A1A1A1A1B1A1A1A000000000000000000000000000000000000000000000000001A1A1A1A1A1A511A1A1A1A
000000000000000000000000000000000000000000000000000000000000000000000000001A893305000533891A
000000000000000000000000000000000000000000000000000000000000000000000000001A893305770533891A
000000000000000000000000000000000000000000000000000000000000000000000000001A8933058C0533891A
000000000000000000000000000000000000000000000000000000000000000000000000001A893305000533891A
000000000000000000000000000000000000000000000000000000000000000000000000001A893305740533891A
000000000000000000000000000000000000000000000000000000000000000000000000001A893305790533891A
000000000000000000000000000000000000000000000000000000000000000000001A1B1A1A1A1A1A541A1A1A1A
000000000000000000000000000000000000000000000000000000000000000000001A7A7977000000000083831A
000000000000000000000000000000000000000000000000000000000000000000001AA0777914A200A00077221B
000000000000000000000000000000000000000000000000000000000000001A1A1A1A411A1A1A00008C0079221A
0000000000000000000000000000000000000000000000000000001A1A1A1A1A8000000000801A000000B313141A
0000000000000000000000000000000000000000000000000000001A79741B000000A1000000540000891A1A1A1A
0000000000000000000000000000000000000000000000000000001A7A7A1A1A0000000000001AC2701A1A000000
0000000000000000000000000000000000000000000000000000001A1A1A1A1A0000148C00A01A1A1A1A00000000
0000000000000000000000000000000000000000000000000000000000001A1BB10013000000131B000000000000
000000000000000000000000000000000000000000000000000000000000001A0000C1C3C300131A000000000000
000000000000000000000000000000000000000000000000000000000000001A1A0000C1C1001A1A000000000000
00000000000000000000000000000000000000000000000000000000000000001A88000000881A00000000000000
00000000000000000000000000000000000000000000000000000000000000001A25255025251A00000000000000
00000000000000000000000000000000000000000000000000000000000000000025797577250000000000000000
00000000000000000000000000000000000000000000000000000000000000000025007A00250000000000000000
00000000000000000000000000000000000000000000000000000000000000000025252625250000000000000000
00000000000000000000000000000000000000000000000000000000000000000000000000000000000000000000
00000000000000000000000000000000000000000000000000000000000000000000000000000000000000000000
0000000000000000000000000000000000000E0E0000000000000000000000000000000000000000000000000000
000000000000000000000000000000000000000D0000000000000000000000000000000000000000000000000000
00000000000000000000000000000000000000000900180000000000000000000000000000000000000000000000
0000000000000000000000000000000000000000090018000000000B000000000000000000000000000000000000
00000000000000000000000000000000000000000018180000000000000000000000000000000000000000000000
0000000000000000000000000000000000000000000000000A000000000000000000000000000000000000000000
0000000000000000000000000000000000000000000000000A000000000000000000000000000000000000000000
00000000000000000202000000000000000000000000000000000000000000000000000000000000000000000000
00000000000000000100000000000000000000000000000000000000000000000000000000000000000000000000
0000000000000000000000000000000000000000000000000000000C0C0C0C0C0C0C000011111100000000000000
00000000000000000000000000000000000800000000000000000000000000000000000000000000000000000000
000000000000000000000000000000000000000000000000000000000000000000000F0000000000000000000000
00000000000000000000000600000505050000000000000000000000000000000000000000000000000000100000
0000000000000000000000060000000000000000000000000000000C0C0C0C0C0C0C000000000000000000000000
00000000000000000000000000030000000000000000000000000000000000000000000000000000000000000000
00000000000000000000000000030000000004000000000000000000000000000000000000000000000000000000
00000000000000000000030303000000000004000000000000000000000000000000000000120000000000000000
00000000000000000400000000000000000004000000000000000000000000000000000000000000000000000000
00000000000000000400000000000000000000000000000000000000000000000000000000000000000000000000
00000000000000000400000000000000000000000000000000000000000000000000000000000000000000000000
00000000000000000000050500000000000000000000000000000000000000000000131300000000000000000000
00000000000000000000000000000000000000000000000000000000000000000000000013000000000000000000
00000000000000000000000007000000000000000000000000000000000000000000000013000000000000000000
00000000000000000000000000000000000000000000000000000000000000000000000014140000000000000000
00000000000000000000000000000000000000000000000000000000000000000000000000001400000000000000
00000000000000000000000000000000000000000000000000000000000000000000000000000000000000000000
00000000000000000000000000000000000000000000000000000000000000000000000000000000000000000000
00000000000000000000000000000000000000000000000000000000000000000000000000000000000000000000
00000000000000000000000000000000000000000000000000000000000000000000000000000000000000000000
00000000000000000000000000000000000000000000000000000000000000000000000000000000000000000000
00000000000000000000000000000000000000000000000000000000000000000000000000000000000000000000
00000000000000000000000000000000000000000000000000000000000000000000000000000000000000000000
00000000000000000000000000000000000000000000000000000000000000000000000000000000000000000000
00000000000000000000000000000000000000000000000000000000000000000000000000000000000000000000
00000000000000000000000000000000000000000000000000000000000000000000000000000000000000000000
00000000000000000000000000000000000000000000000000000000000000000000000000000000000000000000
00000000000000000000000000000000000000000000000000000000000000000000000000000000000000000000
00000000000000000000000000000000000000000000000000000000001615000000000000000000000000000000
00000000000000000000000000000000000000000000000000000000001600000000000000000000000000000000
00000000000000000000000000000000000000000000000000000000000000000000000000000000000000000000
00000000000000000000000000000000000000000000000000000000000000000000000000000000000000000000
00000000000000000000000000000000000000000000000000000000000000000000000000000000000000000000
00000000000000000000000000000000000000000000000000000000000000000000000000000000000000000000
00000000000000000000000000000000000000000000000000000000000000000000000000000000000000000000
00000000000000000000000000000000000000000000000000000000000000000000000000000000000000000000
00000000000000000000000000000000000000000000000000000000000000000000000000000000000000000000
00000000000000000000000000000000000000000000000000000000000000000000000000000000000000000000
00000000000000000000000000000000000000000000000000000000000000000000001700000000000000000000
