100C0000
101010101010101010101010
101010252525101010101010
101010255125101010101010
101010250025101010101010
1010101A001A101010101010
101A1A1A531A1A1A10101010
101A14000000141A1A1B1A10
101A14000000001A00001A10
101B00008C00005000721B10
101A00000000001A00001A10
101A00000000221A1A1B1A10
101A1A1A001A1A1A10101010
101010250125101010101010
101010255125101010101010
101010252525101010101010
101010101010101010101010
000000000000000000000000
000000000000000000000000
000000000200000000000000
000000000400000000000000
000000000000000000000000
000000000300000000000000
000000000000000000000000
000000000000000000000000
000000000000000000000000
000000000000000000000000
000000000000000000000000
000000000000000000000000
000000000000000000000000
000000000100000000000000
000000000000000000000000
000000000000000000000000
