1C3D0302
00000000000000000000000000000000000000000000000000000000000000000000000000001A1A1A1A00000000000000000000000000000000000000
0000000000000000000000000000000000000000000000000000001A1A1A1A1B1A1A1A1A1B1A1A77771A00000000000000000000000000000000000000
1A1A1A1A1A1A1A1A1A1A1A001A1A1A1A1A1A00000000001A1A1A1A1A75A30000001414B17E801470791A1A1A1A1A1A1A1A1A1A1A1A1A1A1A1A1A1A1A1A
1A1313131414140000791A001A707878741A00000000001A7977741A8383008C001374008C0013141A1A7A7779751A00001A7A7977751A89898989891A
1A1313147D00000000881A001AC1C1A3A31A00000000001AA3B0D31B8900000000000000000000A31AC3C3A3A3A31AD3D31AA2A2C2C21A30313131321A
1A0000000000001B00891A1A1A1B1A1A1B1A1A1B1A1A1B1A1A1B1A1A0000771BC12120791B771A411A1A1A1B1A1A1A41411A1A1B1A1A1A05050505051A
1C74028C0000008C00C3008C0000008C7877808CC114798C00007780000000000000000000000000C38C000000148C007913A300008C0000000000001C
1D38383838383838383838383838383838383838383838383838383838383838383838383838383838383838383838383838383838383838383838381D
1E00008C0000008C0000008C0000218C7877808C0000008C00007A80000000000000000000000000008C207700008C0000000000008C0000000000001E
1A1414141400001B00891A201A1B1A1A1B1A1A1B1A1A1B1A1A1B1A1A0000791BC32021771B791A411A1A1A1B1A1A1A1B1A333333331A1AB0008C70051A
1A7A70001300000000881A001AC1C1A3A31A00000000001AA3B0B01AA200000000000000000000A31A000000000000001AA3A3C375711A0000001A331A
1A7A771414A0000083831A001A707777741A00000000001A7977741B897400000000B300000000001B000000000000001A1A1A1A777A1A83000533811A
1A1A1A1A1A1A1B1A1A1A1A001A1A1A1A1A1A00000000001A1A1A1A1A1314008C000000708C0083751A000000000000000000001A1A1A1A1A541A1A1A1A
0000000000000000000000000000000000000000000000000000001A1413141400A32020008083781A000000000000000000000000001A8800881A0000
0000000000000000000000000000000000000000000000000000001A1A1A1A1B1A1A1A1A1B1A1A1A1A00000000000000000000001A1A1A7700791A1A1A
0000000000000000000000000000000000000000000000000000000000000000000000001A1A1A1A0000000000000000000000001AD133008C0033D31A
0000000000000000000000000000000000000000000000000000000000000000000000001A81811A0000000000000000000000001AD13300A30033D31A
0000000000000000000000000000000000000000000000000000000000000000000000001A33331A0000000000000000000000001AD13300000033D31A
0000000000000000000000001A1A1B1A1A1A0000000000000000000000000000000000001A05051A1A1A1A1B1A1A1A00000000001AD133748C7033D31A
0000000000000000000000001A7477797A1B000000001A1A1A1B1A1A1B1A1A1B1A1A1B1A1A7A7933D31A7A7779751A000000001A1A1A1A8900891A1A1A
0000000025252525250000001AB0B0C2C21A000000001A1413B300207940C100800077751A757033D31AB2C2C2C21A001A1A1A1A13141A1A541A1A891A
0000000025000000251A1A1A1A1A1A1A1B1A1A1A1B1A1A137A0000000040000000A300831A1A1A1B1A1A1A1B1A1A1A1B1A14131A77000000000000741A
00000000250077C2251AB00000000000D1007A2000000000001B8900001B008C001B00008CA300001414138C00C120008C00711AA2001B00001B00001A
000000002600757A5000383838383838383838383838383838383838383838383838383838383838383838383838383838383854000041C0C04100001B
00000000250079C2251A00007920000000008C0000A11300001B8900001B0000A31B00008C0000002000008C000089008CA1801A00B31B77791B00A21A
0000000025000000251A1A1A1A1A1A1A1B1A1A1A1B1A1A1479A0008CC1400000000077831A1A1A1B1A1A1A1B1A1A1A1B1A1A1A1A887A000000007A881A
000000002525252525000000000000000000000000001A131400008079400000200083831A00000000000000000000000000001A1A1A1A1A1A1A1A1A1A
000000000000000000000000000000000000000000001A1A1A1B1A1A1B1A1A1B1A1A1B1A1A000000000000000000000000000000000000000000000000
00000000000000000000000000000000000000000000000000000000000000000000000000000000000000000000000000000000000000000000000000
00000000000000000000000000000000000000000000000000000000000000000000000000000008080000000000000000000000000000000000000000
00000000000000000000000000000000000000000000000000000000000000000000000000000008080000000000000000000000000000000000000000
00000000000000000000000000000000000000000000000000000000000000000000000000000007000000000000000000000000000000000000000000
00000000000000000000000000000000000000000000000000000000000000000000000000000000000000000000000000000000000000000000000000
00000000000000000000000000000006060000000000000004040000000000000000000000000000000A0A000000000000000E0E0E0000000000000000
0000000000000000000000000000050000000000000000000300000000000000000000000000000000000000090000000000000000000D000000000000
0000000000000000000000000000050000000000000000000300000000000000000000000000000000000000090000000000000000000D000000000000
0000000000000000000000000000000000000000000000000300000000000000000000000000000000000000090000000000000000000D000000000000
00000000000000000000000000000006060000000000000004040000000000000000000000000000000000000000000000000000000000000000000000
000000020100000000000000000000000000000000000000000000000000000000000000000000000000000000000000000000000C0C0B000000000000
000000000000000000000000000000000000000000000000000000000000000000000000000000000000000000000000000000000C0C00000000000000
00000000000000000000000000000000000000000000000000000000000000000000000000000000000000000000000000000000000000000000000000
00000000000000000000000000000000000000000000000000000000000000000000000000000000000000000000000000000000000000000000000000
00000000000000000000000000000000000000000000000000000000000000000000000000000000000000000000000000000000000000000000000000
00000000000000000000000000000000000000000000000000000000000000000000000000000000000000000000000000000000000000000000000000
00000000000000000000000000000000000000000000000000000000000000000000000000000000000000000000000000000000000000000000000000
00000000000000000000000000000000000000000000000000000000000000000000000000000000000000000000000000000000000000000000000000
00000000000000000000000000000000000000000000000000000000000000000000000000000000000000000000000000000000000000000000000000
00000000000000000000000000000000000000000000000000000000000000000000000000121200000000000000000000000000000000000000000000
00000000000000000000000000000000000000000000000000000000000000000000000011121200000000000000000000000000000000000000000000
00000000000000000000000000000014140000000000000000000000000000000000000000000000000000101010000000000000000000000000000000
00000000000000000000000000001300000000000000000000000000000000000000000000000000000000000000000000000000000000000000000000
0000000015000000000000000000130000000000000000000000000000000000000000000000000000000F000000000000000000000000000000000000
0000000000000000000000000000130000000000000000000000000000000000000000000000000000000F000000000000000000000000000000000000
00000000000000000000000000000000000000000000000000000000000000000000000000000000000000000000000000000000000000000000000000
00000000000000000000000000000000000000000000000000000000000000000000000000000000000000000000000000000000000000000000000000
00000000000000000000000000000000000000000000000000000000000000000000000000000000000000000000000000000000000000000000000000
