29290000
000000000000000000001A1A1B1A1A1B1A1A1A1A1A1A1A1B1A231B1A1A1A0000000000000000000000
000000000000000000001A830000008C007180408000B18C00000000801A0000000000000000000000
000000000000000000001A830000C10000D07540770000000000B100001A0000000000000000000000
000000000000000000001B8300C11A1B1A1A401A1A1A1A1B1A1A1A00831B0000000000000000000000
000000000000000000001A00B0001A830000001414751300801A8500001A0000000000000000000000
000000000000000000001A0000001AA30000008C000000A3001A78C3001A0000000000000000000000
000000000000000000001B008C001B00A31A0000001AA3008C51008C001B0000000000000000000000
000000000000000000001A837A001A00001B0000001B0000001A0000001A0000000000000000000000
000000000000000000001A8383008C00801AA300A31A8000801A0000801A0000000000000000000000
1A1A1A1B1A1A1B1A1A1A1A1A1A1A1A1A1A1A1A541A1A1A1B1A1A4040401A1010102C1010102C101010
1A8083777700007A801A1A1A1A1A1A1A1A1B748C001B74037A1AB0B000001075000000A20000008910
1A3279008C000020711B1A1A1A1A1A1A1A1AA200A21A0000791B1A1A1A1A1083830000202000003110
1A3100A10000D200001A1A1A1A1A1A1B1A1A1A511A1A1A511A1A101010102C83008C0000A28C003110
1A318C0020200000141A1A1A1A1A83790000A200A20000008010101010101080B10000A28078003110
1A30790020200000741B1A1A1A1B00000000000000000000782C101010101010105110101080003110
1A807900C1C17777801A1A1A1A1AB0001A1A1A8C10101000781010101010108000C000891000003110
1A1A1A511A1A1B1A1A1A1A1B1A1A00001A89760074891000001010102C101000008C00002C00003210
1A32780000000080B0400000B01A00001A7600C000781000C310807476C143C00083837610A3A31010
1A31778C0000008C001A8C00005100008C00A181C0008C00005100008C00180000832079108CB00023
1A30780014807800B0540000B01A0000107800A100761A00C310807876C151C00000000010C3C31010
1A1A1A511A1A1B1A1A1A1A1B1A1AB0001089740076891A00001010102C101000008C00002C00003010
1AC100001AA1008375231A1A1A1A00001010108C1A1A1A000010A3A2007A108000C000891000003110
1BC1000040A10083791B1A1A1A1B00000000000000000000002C00D200001010105110101000003110
1A1A1A511A000000001A1A1A1A1A80770000D300D30076768310C0000070108000A2000041B0003110
1A76000000000000201A1A1A1A1A102C101010511010102C1010101010101000000000212100003110
1BB0008C00D18C00001B1A1A1A1A15007015D300D378747A7710101010102C00A38C007A218C003110
1A83830020207783831A1A1A1A1A15777910778C00000000792C10101010108377000000A300003110
1A1A1A1B1A1A1B1A1A1A1A1A1A1A157A75157970000074000010101010101083830013000000008910
0000000000000000001515152315151515154242511516155115151615151010102C1010102C101010
00000000000000000015807A000080157400D38CD30000000000007983150000000010741000000000
00000000000000000015000000000015838300007676787814000000761500000000107A1000000000
00000000000000000016D3D381A2A21515151516151515161500008C781600000000107D1000000000
0000000000000000001570212021000000890000000000A20000008375150000000010101000000000
0000000000000000001500000000000000B07877137676008C00A283C2150000000000000000000000
0000000000000000001633333333331515151542151515000000151515151500000000000000000000
000000000000000000150505050505B0000000B000831680767815757A001500000000000000000000
0000000000000000001580C0C0A2A2B000140000008315807480151579711500000000000000000000
0000000000000000001515151615151515252550252515151515151515151500000000000000000000
0000000000000000000000000000000000250000002500000000000000000000000000000000000000
0000000000000000000000000000000000250000002500000000000000000000000000000000000000
0000000000000000000000000000000000252526252500000000000000000000000000000000000000
0000000000000000000000000000000000000000000000000007000000000000000000000000000000
0000000000000000000000000000000000000000000000000000000000000000000000000000000000
0000000000000000000000000000000000000000000000000000000000000000000000000000000000
0000000000000000000000000000000000000000000000000000000000000000000000000000000000
0000000000000000000000000000000000000000000000000000000000000000000000000000000000
0000000000000000000000000000000000000000000000000000000000000000000000000000000000
0000000000000000000000000000000000000000000000000000000000000000000000000000000000
0000000000000000000000000000000000000000000000000000000000000000000000000000000000
0000000000000000000000000000000000000000000000000000000000000000000000000000000000
0000000000000000000000000000000000000000000000000000000000000000000000000000000000
0000000000000000000000000000000000000000000000000000000000000000000000000000000000
0000000000000000000000000000000000000000000000000000000000000000000000000000000000
0000000000000000000000000000000000000006000000000000000000000000000000000000000000
0000000000000000000000000000000000000000000000000000000000000000000000000000000000
0000000000000000000000000000000000000000000000000000000000000000000000000000000000
0000000000000000000000000000000000000000000000000000000000000000000000000000000000
0000000000000000000000000000000000000000000000000000000000000000000000000000000000
0000000000000000000000000000000000000000000000000000000000000000000000000000000000
0000000000000000000000000008000000000000000000000000000000000000000000000000000005
0000000000000000000000000000000000000000000000000000000000000000000000000000000000
0000000000000000000000000000000000000000000000000000000000000000000000000000000000
0000000000000000000900000000000000000000000000000000000000000000000000000000000000
0000000000000000000000000000000000000000000000000010110000000000000000000000000000
0000000000000000000000000000000000000000000000000000000000000000000000000000000000
000000000000000000000000000000000000000A000000000000000000000000000000000000000000
0000000000000000000000000000000000000000000000000000000000000000000000000000000000
0000000000000000000000000000000002010000000000000000000000000000000000000000000000
0000000000000000000000000000000000000000000000000000000000000000000000000000000000
0000000000000000000000000E00000000000000000000000000000000000000000000040000000000
0000000000000000000000000000000000000000000000000000000000000000000000030000000000
0000000000000000000000000000000000000000000000000000000000000000000000000000000000
0000000000000000000000000000000000000000000000000000000000000000000000000000000000
0000000000000000000000000000000000000000000000000000000000000000000000000000000000
0000000000000000000000000000000000000000000000000000000000000000000000000000000000
000000000000000000000F0F0F0F0F0000000000000000000000000000000000000000000000000000
00000000000000000000000000000000000000000000000000000C0B00000000000000000000000000
0000000000000000000000000000000000000000000000000000000000000000000000000000000000
0000000000000000000000000000000000000000000000000000000000000000000000000000000000
0000000000000000000000000000000000000000000000000000000000000000000000000000000000
0000000000000000000000000000000000000000000000000000000000000000000000000000000000
000000000000000000000000000000000000000D000000000000000000000000000000000000000000
