20220907
0000000000000000000000001A1A1A1B1A1B1A1B1A1A1A0000000000000000000000
0000000000000000000000001AB233778972897933B21A0000000000000000000000
0000000000000000000000001A33337700D2007933331A0000000000000000000000
0000000000000000000000001B7700000070000000741B0000000000000000000000
0000000000000000000000001A008C20202020208C001A0000000000000000000000
0000000000000000000000001B0000000000000000001B0000000000000000000000
0000000000000000000000001AD200A1008C00A100D21A0000000000000000000000
0000000000000000000000001B7900882077208800791B0000000000000000000000
0000000000000000000000001A1300202100212000831A0000000000000000000000
0000000000000000000000001B130000008C000000791B0000000000000000000000
0000000000000000000000001A147700C200C20075801A0000000000000000000000
0000000000000000000000001A1A1B1A1A541A1A1B1A1A0000000000000000000000
0000000000000000000000001A80A140C2D2D240A3801A0000000000000000000000
0000000000000000000000001B80A140B28CB240A3801B0000000000000000000000
0000000000000000000000001A80A140A2A2A240A3801A0000000000000000000000
171819181918191819171A1A1A1A1B1A1B1B1B1A1B1A1A1A1A00001A1A1A231A1A1A
177183007777778088171A838300708900B20089000083831A00001A83797779831A
180083008C000000A0191A83C1C28C00007400008CC2C1831A00001A89008C00891A
190000C20000212000181B00000021211A1B1A21210000001B00001A8800B200881A
1800000000742021A1171A89000021201A231A20210000891A1A1A1A1A1A511A1A1A
19002033200043B1A1C11400790000A3880088A30000770013C3C3A3A3790000801A
2DD03381330043B1A1C1138C798C000000000000008C778C14C3C38C79208C00131A
19002033200043B1A1C1140079002079000000772000770013C3C3A3A3770000131A
1800000000752021A1171A8900A321208000802021A300891A1A1A1A411A8C00141A
190000C20000212000171B000000212143434321210000001A77771AB0000000791A
181313008C000000A0191A8374008C00007D00008C0074141A79791A7A008C00001A
171314007979798088171A838380000000010000008013131A71741A13131314751A
171717171918191817171A1A1A1A1B1A1A541A1A1B1A1A1A1A1A1A1A1A1A1A1A1A1A
000000177A7A7A170000000000002525258C25252500000000000000000000000000
00000017747174170000000000002588797779882500000000000000000000000000
00000017171717170000000000002513747074142500000000000000000000000000
00000000000000000000000000002525252625252500000000000000000000000000
00000000000000000000000000000000000000000000000000000000000000000000
00000000000000000000000000000000000000000000000000000000000000000000
00000000000000000000000000000000000000000000000000000000000000000000
00000000000000000000000000000000000000000000000000000000000000000000
00000000000000000000000000000000000000000000000000000000000000000000
00000000000000000000000000000000000000000000000000000000000000000000
00000000000000000000000000000000000000000000000000000000000000000000
00000000000000000000000000000000000000000000000000000000000000000000
00000000000000000000000000000000000000000000000000000000000000000000
00000000000000000000000000000000000000000000000000000000000000000000
00000000000000000000000000000000000000000000000000000000000000000000
00000000000000000000000000000000000000000000000000000000000000000000
00000000000000000000000000000000000000000000000000000000000000000000
00000000000000000000000000000000000000000000000000000000000000000000
00000000000000000000000000000000000000000000000000000000000000000000
00000000000000000000000000000000080808000000000000000000000005000000
00000000000000000000000000000000000000000000000000000000000000000000
00000000000000000000000000000000000000000000000000000000000000000000
00000000000000000000000000000000000000000000000000000000000000000000
00000000000000000000000000000000000300000000000000000000000000000000
00000000000000000000060000000000000000000000000004000000000000000000
07000000000000000000060000000000000000000000000004000000000000000000
00000000000000000000060000000000000000000000000004000000000000000000
00000000000000000000000000000000000000000000000000000000000000000000
00000000000000000000000000000000000000000000000001020000000000000000
00000000000000000000000000000000000000000000000000000000000000000000
00000000000000000000000000000000000000000000000000000000000000000000
00000000000900000000000000000000000B00000000000000000000000000000000
00000000000A00000000000000000000000000000000000000000000000000000000
00000000000000000000000000000000000000000000000000000000000000000000
00000000000000000000000000000000000000000000000000000000000000000000
00000000000000000000000000000000000C00000000000000000000000000000000
