17220100
15151010101010101010101010101010101010101010101010101010101010101010
15153031313131313131321A30313131313131313131313131313131313131313110
15157000131414141313141A14131414130075001414131300791313000077143110
15157800A10000000000891E8900000000000000A100000000000000A30000143110
15163838383838383838381D38383838383838383838383838383838383814143110
15150000000000000000001C00000000000000000000000000000000000014143110
15150033333333330000001A00A01817174317181719171817175117181313133110
15150033050505330000005200004386000000170000001700000013171313133110
1685003305C005330000001B00001783A17200510000005300008C13171313133110
12000033050505330000001A141318838C000017A200A017007B7421181313133110
11000033333333330000001A1A1A1813838383178C008C1721000021171313133110
16850000000000000000001A1A1A1714838383170000001722008C1F171313133110
15150000000000000000891A1A1A1714148383181750171820860020171313133110
15150000000000002122211A1A1A1817171917188000801817174317171313133110
1515151651161515217D211A1A1A1A1A1A1A1A000000000000000000131313133110
15158000000080152121211A1A1A1A1A1A1A1B000000000000007600001414133110
15150000000000151515151A1A1A1A1A1A1A1A000000000000000000000014133110
151500008C0000871515151A1A1A1B1A231A1A1A1B541B1A1A000000000082843110
151500A100B000151515151A1A21000000001A00000000201A000000000082843110
15158000000080151515151A1A2074A18C005400008C000040000400008282823110
15151515501515151515151A1A21000000001A00000000001A000000008484843110
15151525002515151515151A1A1A1B1A1A1A1A86212022211A1B12111B1A32313110
15151525262515151515151A1A1A1A1A1A1A1A1A1A1A1A1A1A101010101010101010
00000000000000000000000000000000000000000000000000000000000000000000
00000000000000000000000000000000000000000000000000000000000000000000
00000000000000000000000000000000000000000000000000000000000000000000
00000000000000000000000000000000000000000000000000000000000000000000
00000000000000000000000000000000000000000000000000000000000000000000
00000000000000000000000000000000000000000000000000000000000000000000
00000000000000000000000000000000000000000000000000000000000000000000
00000000000000000000000000000000000000000000000000000000000000000000
00000000000000000000000000000000000000000000000300000000000000000000
00000000000000000000000000000000000000000000000000000000000000000000
00000000000000000000000000000000000000000000000000000000000000000000
00000000000000000000000000000000000000000000000000000000000000000000
00000000000000000000000000000000000000000001000000000000000000000000
00000000000000000005000000000000000000000000000000000000000000000000
00000000000000000006000000000000000000000000000000000000000000000000
00000000000000000000000000000000000000000000000000000000000000000000
00000000000000000000000000000000000000000000000000000000000000000000
00000000000000000000000000000000020000000000000000000000000000000000
00000000000000000000000000000000000000000000000000000000000000000000
00000000000000000000000000000000000000000000000000000000000000000000
00000000000000000000000000000000000000000000000000000000000000000000
00000000000000000000000000000000000000000000000000000000000000000000
00000000040000000000000000000000000000000000000000000000000000000000
