2C360004
000000000000000000000000000015151515151515000000000000000000000000000000000000000000000000000000000000000000
000000000000000000000000000015797977757215000000000000151515151500000000000000000000000000000000000000000000
000000000000000000000000000015A0B3D2C2B215000000000000157579701500000000000000000000000000000000000000000000
00000000000015151516151516151516151516151516151516151515B377771500000000000000000000000000000000000000000000
15151516151515B03305008874880000C3000000000000B300707915A3C3791500000000000000000000000000000000000000000000
158800770020153315000000000000002021401AA1008C0083757715A3C37A1500000000000000000000000000000000000000000000
1500001600001505000016A3000000007974770000000000838383151515151515151515151500000000000000000000000000000000
1602748C0000510000007900008C1A1A1A231A1A1A0000000000000088158300A274147A771500000000000000000000000000000000
150000160000150000A3160000801A14131414131A79001600008C00B35400008C001479791500000000000000000000000000000000
158800790083150000000000000041B3007A008083830000001400008815790000A21413141500000000000000000000000000000000
1515151615151589830000002020210000000000C2830000001515161515000000000000891500000000000000000000000000000000
000000000000151515800000C3C02100008C000000000074801500158930050013797700001500000000000000000000000000000000
000000000000000015161579770000000000A3000000001516150015893105B313141400B31500000000000000000000000000000000
00000000000000000000151515800000131389751413141500000015893105007A227A00001500000000000000000000000000000000
0000000000000000000000001515151615151615151615150000001589320500000000C1051500000000000000000000000000000000
00000000000000000000000000000000001A1A701A00000000000015151515008C000015331500000000000000000000000000000000
00000000000000000000000000000000001BD3B21B000000000000001580000079770533811500000000000000000000000000000000
0000000000000000000000000000001A1A1A00731A00000000000000157400C100008315151500000000000000000000000000000000
0000000000000000000000000000001A13008C001A1A1B1A1A1B1A1A1500002000838315000000000000000000000000000000000000
0000000000000000000000000000001B0000A0001383A1008921748015A3000000151515000000000000000000000000000000000000
0000000000000000000000000000001A0000008C000000008C00A1005200000000150000000000000000000000000000000000000000
0000000000000000000000000000001A1A1413C077770000207900801588007788150000000000000000000000000000000000000000
000000000000000000000000000000001A1A1A1B1A1A1B1A1A1B1A1A1515541515150000000000000000000000000000000000000000
0000000000000000000000000000000000000000001A74771A1A1A1A1A1A001A1A1A0000000000000000000000000000000000000000
0000000000000000000000000000000000000000001AA3C21A75704079000083831A0000000000000000000000000025252625250000
0000000000000000000000000000000000000000001AA3C21B79B3400000C300831A0000000000000000000000000025790079250000
0000000000000000000000000000000000000000001A1A1A1A77A14000228C00001B00000000000000000000000000257A8C77250000
0000000000000000000000000000000000000000000000001A00A140A300C000001A0000000000000000000000000025257525250000
0000000000000000000000000000000000000000000000001B00B11A000000B3131A00000000000000000000001A1A1A1A501A1A1A1A
0000000000000000000000000000000000000000000000001A80005100007713131A00000000000000000000001A893205D20530811A
0000000000000000000000000000000000000000000000001A1A1A1A1A541A1A1A1A00000000000000000000001A893105000531811A
0000000000000000000000000000000000000000000000001A8383A10000A313141A00000000000000000000001A8931058C0531811A
0000000000000000000000000000000000000000001A1A1A1A830000000000007A1A00000000000000000000001A893105D20531811A
0000000000000000000000000000000000000000001AB140790000001BA2001B001B00000000000000000000001A893005000532811A
0000000000000000000000000000000000000000001AB1407700008C00777900001A1A1A0000000000000000001A1A1A1A511A1A1A1A
0000000000000000000000000000000000000000001A1A1A1A0000C020212120001A891A1A1A000000000000001A80C200C2801A0000
0000000000000000000000000000000000000000000000001A83830000C38C00001B7983831A1A1B1A1A1A1A1A1B74000000771B0000
0000000000000000000000000000000000000000000000001B74790000000000B31A000000770000C3801AA2A31A7A000000701A0000
0000000000000000000000000000000000000000000000001A1A1A1413131A1A541AA2008C00008C00741A40401A1300B300881A0000
00000000000000000000000000000000000000000000000000001A1A1A1A1A1A00000000D3A0131400001A770000000000881A1A0000
000000000000000000000000000000000000000000000000000000000000001A88000000000013C20000540000A00000831A1A1A1A1A
000000000000000000000000000000000000000000000000000000000000001A1A1B1A1A7700000000801A00A0000000791AD37A751A
00000000000000000000000000000000000000000000000000000000000000000000001A1A1A1A1B1A1A1A1A1B1A1A1B1A1A7779711A
000000000000000000000000000000000000000000000000000000000000000000000000000000000000000000000000001A1A1A1A1A
000000000000000000000000000000000000000000000000000000000000000000000000000000000000000000000000000000000000
000000000000000000000000000000000000000000000000000000000000000000000000000000000000000000000000000000000000
000000000000000000000000000000000000000000000000000000000000000000000000000000000000000000000000000000000000
000000000000000000000000000000000404040000000000000000000000000000000000000000000000000000000000000000000000
000000000000000000000000000000000000000000000000010000020000000000000000000000000000000000000000000000000000
000000000000000000000000000000000000000000000000000000020000000000000000000000000000000000000000000000000000
000000000000000000000000000000000000000000000000000000000000000000000000000000000000000000000000000000000000
000000000000000000000000000000000003000000000000000000000000000000000009090000000000000000000000000000000000
000000000000000000000000000000000000000000000000000000000005000000000009090000000000000000000000000000000000
000000000000000000000000000000000000000000000000000000000000000000000008000000000000000000000000000000000000
000000000000000000000000000000000000000000000000000000000000000000000000000000000000000000000000000000000000
000000000000000000000000000000000000000000000000000000000000000000000000000000000000000000000000000000000000
000000000000000000000000000000000000000000000000000000000000000000000000000000000000000000000000000000000000
000000000000000000000000000000000000000000000000000000000000000000000000000000000000000000000000000000000000
000000000000000000000000000000000000000700000000000000000000000000000000000000000000000000000000000000000000
000000000000000000000000000000000000000000000000000000000000000000000000000000000000000000000000000000000000
000000000000000000000000000000000000000000000000000000000000000000000000000000000000000000000000000000000000
000000000000000000000000000000000000000000000000000000000000000000000000000000000000000000000000000000000000
000000000000000000000000000000000000000000000000000000000000000000000000000000000000000000000000000000000000
000000000000000000000000000000000000000000000000000000000000000000000000000000000000000000000000000000000000
000000000000000000000000000000000000000000000000000000000000000000000000000000000000000000000000000000000000
000000000000000000000000000000000000000000000000000000000000000000000000000000000000000000000000000000000000
000000000000000000000000000000000000000000000000000000000000060000000000000000000000000000000000000000000000
000000000000000000000000000000000000000000000000000000000000000000000000000000000000000000000000000000000000
0000000000000000000000000000000000000000000000000B0000000000000000000000000000000000000000000000000E00000000
0000000000000000000000000000000000000000000000000B0000000000000000000000000000000000000000000000000000000000
000000000000000000000000000000000000000000000000000000000000000000000000000000000000000000000000000000000000
000000000000000000000000000000000000000000000000000A0A000000000000000000000000000000000000000000000000000000
000000000000000000000000000000000000000000000000000000000000000000000000000000000000000000000000000000000000
000000000000000000000000000000000000000000000000000000000000000000000000000000000000000000000000000000000000
000000000000000000000000000000000000000000000000000000000000000000000000000000000000000000000000000000000000
000000000000000000000000000000000000000000000000000000000000000000000000000000000000000000000000000000000000
000000000000000000000000000000000000000000000000000000000000000000000000000000000000000000000000000000000000
000000000000000000000000000000000000000000000000000000000000000000000000000000000000000000000000000000000000
000000000000000000000000000000000000000000000000000000000000000000000000000000000000000000000000000000000000
000000000000000000000000000000000000000000000000000000000000000000000000000000000000000000000000000000000000
000000000000000000000000000000000000000000000000000000000000000000000000000000000000000000000000000000000000
000000000000000000000000000000000000000000000000000000000000000000000000000000000000000000000000000000000000
000000000000000000000000000000000000000000000000000000000000000000000000000000000000000000000000000000000000
000000000000000000000000000000000000000000000000000000000000000000000000000000000000000000000000000000000000
000000000000000000000000000000000000000000000000000000000000000000000000000000000000000000000000000000000000
000000000000000000000000000000000000000000000000000000000000000000000000000000000000000000000000000C0D0D0D00
00000000000000000000000000000000000000000000000000000000000000000000000000000000000000000000000000000D0D0D00
000000000000000000000000000000000000000000000000000000000000000000000000000000000000000000000000000000000000
