11110000
1717171717171717191717171717171717
1717171718181717871717181817171717
1717800000000000000000000000801717
1717000000000505050505000000001717
171800000005393A3B3C3D050000001817
1718000005000000000000000500001817
171700053D008C0000008C003905001717
171700053C000000000000003A05001717
198700053B000000010000003B05008719
171700053A000000000000003C05001717
1717000539008C0000008C003D05001717
1718000005000000000000000500001817
1718000000053D3C3B3A39050000001817
1717000000000505050505000000001717
1717800000000000000000000000801717
1717171718181717871717181817171717
1717171717171717191717171717171717
0000000000000000000000000000000000
0000000000000000000000000000000000
0000000000000000000000000000000000
0000000000000000000000000000000000
0000000000000000000000000000000000
0000000000000000000000000000000000
0000000000000000000000000000000000
0000000000000000000000000000000000
0000000000000000000000000000000000
0000000000000000000000000000000000
0000000000000000000000000000000000
0000000000000000000000000000000000
0000000000000000000000000000000000
0000000000000000000000000000000000
0000000000000000000000000000000000
0000000000000000000000000000000000
0000000000000000000000000000000000
