36330105
000000000000000000000000000000000000000000001A1A1A1B1A1A1A1B1A2525252500000000000000000000000000000000
000000001717171717171717170000000000000000001A797977891A890089257A7A2500000000000000000000000000000000
000000001787878787878787170000000000000000001B77D17A745300D1005379792600000000000000000000000000000000
000000001730313131313132170000000000000000001A890000891A8900892577772500000015151516151615151500000000
000017191705050505050505171917000000000000001A1A1A531A1A1A1B1A2525252500151515890000000000891515150000
001717000000000000000000000017170000000000001A137A75791A00000000000000151583000000777A77A1000013151500
0019000077148300D1008313790000190000000000001A007777791A00000000000000158300A1000014131400000000141500
1717C10077138300A10083147900C1171700000000001A050505051A000000000000151500000000000074000000B000001515
17000000057A00A1A1A1007A05750089171A1A1A1B1A1A333333331A1A1B1A1A1A1A15880000771400A100B000130000008815
1800001733170000D000001733170000181A88B00083830000000000790000B0881A1500000079130000000000140000007715
19000533811788777279881781330500171A00000000000000C2000014000000001A150000C28914007A2275001389B0007715
18A105338117171717171717813305A100540000A0007413000000001383A000005400000000000000222222000000D1007315
19000533811788007100881781330500171A8300000077130000C20014830000001A15000000891300792277001489A1007915
18007517331700000000001733170000181A8814000000000000000000000013881A150000C279140000000000130000007915
17000000050000A300A3000005000089171A1A1A1B1A1A1A1A511A1A1A1B1A1A1A1A15880000771300000000001400B0008815
171700001479790000007777130000171700000000001A88007400881A000000000015150000000000007400A1000000001515
0017C10000B10022222200B10000C1190000000000001A0000B200001A0000000000001583830000001413140000A100001500
00171700000000007A000000000017170000000000001B00001413771B000000000000151583830000C200C200000000151500
000019191789000000000089171917000000000000001AA1000000001A00000000000000151515890000000000891515150000
000000001717171754171717170000000000000000001A000070A1001A00000000000000000015151615541516151500000000
00000000001A80000000801A000000000000000000001B79131400001B000000000000000000001A1A1A001A1A1A0000000000
00000000001A00A20000831B000000000000000000001A000000C2001A000000000000001313131388000000881A0000000000
1A1A1B1A1A1A00000000831A000000001A1A1A1A00001A88000000881A00000000000000137A7A1300A114A1001B0000000000
1A8300B00005007779A2001A1A1A1A1A1A7A771A001A1A1A1A501A1A1A1A0000000000001371751474A1A179791A0000000000
1B8300751A331A141400001A74C17AC11471751A1A1A1314130000A0001A1A0000000000137977131A511A40401A0000000000
1A000005338133050000001AA2A2A2A21A797A1A1A80000000000077A2801A1A00000000131313137900A200A21A0000000000
1B00B0001A331A000000131A1A1B1B1B1A1A1A1A80000000000013141414141A1A1A1B1A1B1A1A1A00A300A2001A0000000000
1A0000000005000000C1141A8800000079881A880000000000001300000000881A8979790000891A41411A511A1A0000000000
1B771B007A210000000000510000A3007A745000A2A0001300C2000000A0000050747A7AD0000051A200A200741A0000000000
1A00000000050000C100001A8800000077881A880000791300000013740000881A8977770000891A00A21300001B0000000000
1B0000001A331A000000001A1A1A1B1A1A1A1A1A14141414000000141300001A1A1A1B1A1B1A1A1A7700A200001A0000000000
1A00B005338133050000801A000000000000001A1A8000000000000000001A1A000000000000001A1A511A40401A0000000000
1B0000791A331A000013131A00000000000000001A1A790000010000771A1A00000000000000001A83000000741A0000000000
1A8300B0000500000079771A1A00000000000000001A1A1A1A501A1A1A1A0000000000000000001B00A2A200001B0000000000
1A1A1B1A1A1A0000A20000801A0000000000000000001A88007400881A000000000000000000001A000014A2831A0000000000
00000000001B00000000A21A1A0000000000000000001A0000B200001A000000000000000000001A88A20000881A0000000000
00000000001A1A1A541A1A1A000000000000000000001A00001413771A000000000000000000001A1A1A541A1A1A0000000000
000000001515151500151515150000000000000000001AA1000000001A00000000000000000017171717001717171700000000
00001516158000000000008015161500001A1A1A1A1A1A000070A1001A1A1A1A1A1A0000171917880000000000881719170000
0015157A000000D2D100000000791515001AC2C2C2C21A79131400001AC2C2C2C21A00171777000000C100C100000080171700
00167400000505770077050500007716001AC2C2C2C21A000000C2001AC2C2C2C21A0019790000000000000000000000801900
15150000153333157915333315000015151A050505051A88000000881A050505051A1717000013131313000000137900001717
1580000533818133053381813305007A151A333333331A1A1A511A1A1A333333331A1788000013B1C2130000001374A1000017
16790005338181330533818133050079161A7A000000007900000077770000007A1A1700C10014B1C21400B100131400000019
157AD279153333150015333315790077151A7400B10077130000001414000000741A1700000013B1C213000000000000A10017
167CD100770505797579050577000000005400000000791300A200147900B10000540000000013131313007100797900000019
157A0079153333150015333315790077151A0000000013130000001477000000001A1700C10000000000000014171700000017
16770005338181330533818133050079161A88000000777700A2007900000000881A1700000000B100000000141775A1000019
1580000533818133053381813305007A151A1A1A1B1A1A1B1A1A1A1B1A1A1B1A1A1A1788000022202022007713267AD1000017
15150000153333157915333315000015150000000000000000000000000000000000171700000074A121007714177900001717
001677000005057700770505000074160000000000000000000000000000000000000019800000007922000014171700001900
00151579000000D200000000007A15150000000000000000000000000000000000000017178000000000000000000000171700
0000151615800000D1000080151615000000000000000000000000000000000000000000171917000000000000001719170000
000000001515151515151515150000000000000000000000000000000000000000000000000017171717171717171700000000
000000000000000000000000000000000000000000000000000000000000000000000000000000000000000000000000000000
000000000000000000000000000000000000000000000000000000000000000000000000000000000000000000000000000000
000000000000000000000000000000000000000000000000000000030000000400001200000000000000000000000000000000
000000000000000000000000000000000000000000000000000000000000000000000000000000000000000000000000000000
000000000000000000000000000000000000000000000000000200000000000000000000000000000000000000000000000000
000000000000000000000000000000000000000000000000000000000000000000000000000000000000000000000000000000
000000000000000000000000000000000000000000000000000000000000000000000000000000000000000000000000000000
000000000000000000000000000000000000000000000000000000000000000000000000000000000000000000000000000000
000000000000000000000000000000000000000000000001010101000000000000000000000000000000000000000000000000
000000000000000000000000000000000000000000000000000000000000000000000000000000000000000000000000000000
000000000000000000000000000000000000000000000000000000000000000000000000000000000000000000000000000000
000000000000000000000000000000000000000000000000000000000000000000000000000000000000000000000000000000
000000000000000000000000000000000000000000000000000000000000000000000000000000000000000000000000000000
000000000000000000000000000000000000000000000000000000000000000000000000000000000000000000000000000000
000000000000000000000000000000000000000000000000000000000000000000000000000000000000000000000000000000
000000000000000000000000000000000000000000000000000000000000000000000000000000000000000000000000000000
000000000000000000000000000000000000000000000000000000000000000000000000000000000000000000000000000000
000000000000000000000000000000000000000000000000000000000000000000000000000000000000000000000000000000
000000000000000000000000000000000000000000000000000000000000000000000000000000000000000000000000000000
000000000000000000000000000000000000000000000000000000000000000000000000000000000000000000000000000000
000000000000000000000000000000000000000000000000000000000000000000000000000000000000000000000000000000
000000000000000000000000000000000000000000000000000000000000000000000000000000000000000000000000000000
000000000000000000000000000000000000000000000000000000000000000000000000000606000000000000000000000000
000000000000000000000000000000000010100000000000000000000000000000000000000606050000000000000000000000
000000000000000000000000000000000F10100000000000000000000000000000000000000606000000000000000000000000
000000000000000000000000000000000010100000000000000000000000000000000000000000000000000000000000000000
000000000000000000000000000D0D0D0000000000000000000000000000000000000000000000000000000000000000000000
0000000000000000000000000000000E0000000000000000000000000000000000000000000000000000000000000000000000
0000000000000000000000000000000E0000000000000000000000000000000000000000000000000000000000000000000000
0000000000000000000000000000000E0000000000000000000000000000000000000000000000000000000000000000000000
000000000000000000000000000000000000000000000000000000000000000000000000000000000000000000000000000000
000000000000000000000000000000000000000000000000000000000000000000000000000000000000000000000000000000
000000000000000000000000000000000000000000000000000000000000000000000000000000000000000000000000000000
000000000000000000000000000000000000000000000000000000000000000000000000000000000000000000000000000000
000000000000000000000000000000000000000000000000000000000000000000000000000000000000000000000000000000
000000000000000000000000000000000000000000000000000000000000000000000000000000000000000000000000000000
000000000000000000000000000000000000000000000000000000000000000000000000000000000000000000000000000000
000000000000000000000000000000000000000000000000000000000000000000000000000000000000000000000000000000
000000000000000000000000000000000000000000000000000000000000000000000000000000000000000000000000000000
000000000000000000000000000000000000000000000000000000000000000000000000000000000000000000000000000000
000000000000000000000000000000000000000000000000000000000000000000000000000000000000000000000000000000
000000000000000000000000000000000000000000000000000000000000000000000000000000000000000000000000000000
0000000000000000000000000000000000000B0B0B0B0000000000000009090909000000000008000008000000000000000000
000000000000000000000000000000000000000C00000000000000000000000A00000000000008000008000000000000000000
000000000000000000000000000000000000000C00000000000000000000000A00000000000000000000070707000000000000
000000000000000000000000000000000000000C00000000000000000000000A00000000000000000000000007000000000000
000000000000000000000000000000000000000C00000000000000000000000A00000000000000000007000000000000000000
000000000000000000000000000000000000000C00000000000000000000000A00000000000000000007070700000000000000
000000000000000000000000000000000000000000000000000000000000000000000000000000000000000000110000000000
000000000000000000000000000000000000000000000000000000000000000000000000000000000000000000000000000000
000000000000000000000000000000000000000000000000000000000000000000000000000000000000000000000000000000
000000000000000000000000000000000000000000000000000000000000000000000000000000000000000000000000000000
000000000000000000000000000000000000000000000000000000000000000000000000000000000000000000000000000000
000000000000000000000000000000000000000000000000000000000000000000000000000000000000000000000000000000
