373E0902
0000000000000000000000000000000000000000000000000000001A1A1A1A1B1A1B1A1B1A1A1A1A00000000000000000000000000000000000000000000
0000000000000000000000000000000000000000000000000000001A89330570000000750533891A00000000000000000000000000000000000000000000
0000000000000000000000000000000000000000000000000000001A89330579000300770533891A00000000000000000000000000000000000000000000
0000000000000000000000000000000000000000000000000000001A89330500000000000533891A00000000000000000000000000000000000000000000
0000000000000000000000000000000000000000000000000000001A89330500000000000533891A00000000000000000000000000000000000000000000
0000000000000000000000000000000000000000000000000000001A1A1A1A88000000881A1A1A1A00000000000000000000000000000000000000000000
00000000000000000000000000000000000000000000000000000000001A1A1A1A511A1A1A00000000000000000000000000000000000000000000000000
000000000000000000000000000000000000000000000000000000001A1A8879000077881A1A000000000000000000000000000000000000000000000000
0000000000000000000000000000000000000000000000000000001A1A000000A0000000001A1A0000000000000000000000000000000000000000000000
00000000000000000000000000000000000000000000000000001A1A777900000000A00000001A1A00000000000000000000000000000000000000000000
00000000000000000000000000000000000000001A1A1A1A1B1A1A1B1A40401A000000001B00001A1A1A1A00000000000000000000000000000000000000
00000000000000000000000000000000000000001A7A00000000000000B1741A000000000000000083831A00000000000000000000000000000000000000
00000000000000000000000000000000000000001A741400B10000000000001A000077000000A00000831A00000000000000000000000000000000000000
00000000000000000000000000000000000000001A1A1479000000140000000000C377001B00000000001B00000000000000000000000000000000000000
0000000000000000000000000000000000000000001A1A790000001314000000000077000000C30000001A00000000000000000000000000000000000000
000000000000000000000000000000000000000000001A2200000089130000000000000000007779007A1A00000000000000000000000000000000000000
000000000000000000000000000000000000000000001A220000C200000000148300C2001B00000013131A1A000000000000000000000000000000000000
000000000000000000000000000000000000000000001A2200000000000077148383000079007A7A14747A1A000000000000000000000000000000000000
000000000000000000000000000000000000000000001A1A1A1B1A541A1A1A1A1A1A1A1A1B1A1A1A1A79771A000000000000000000000000000000000000
00000000000000000000000000000000000000000000001A8800000000881A1A1A1A1A1A1A1AD0D01A1A1A1A000000000000000000000000000000000000
00000000000000000000000000000000000000000000001A74000000007A1A1A1A1A1A1A1A1A75711A1A1A1A000000000000000000000000000000000000
00000000000000000000000000000000000000000000001B0000000000001B1A1A1A1A1A1A1A1A1A1A1A1A1A000000000000000000000000000000000000
00000000000000000000000000000000000000000000001A00A2000000001A1A1A1A1A1A1A1A1A1A1A1A1A1A000000000000000000000000000000000000
0000000000000000000000000000000000000000000013140000000000891A1A1A1A1A1A1A1A1A1A1A1A1A1A00000000001A1A1A1A1A1A1A000000000000
0000000000000000000000000000000000000000001314800000C300A21A1A1A1A1A1A1A1A77797A1A1A1A1A00000000001A79797777D11A000000000000
00000000000000000000000000000000000000001A138000C30000801A1A1A1A1A1A1A1A1A75A27A1A1A1A1A1A1A1A1A1A1AB0B0B0C2C21A000000000000
000000000000000000000000000000000000001A1A0000000000801A1A1A1A1A1A1A1A1A1A1A131A1A1A1A1A1A2222221A1A1A1A1A1A1A1A1A1A1A1A1A1A
000000000000000000000000000000000000001A00A1000000001B1A1A1A1A1A1A1A1A1A880000881A747A0000000070000000000000791A88777779881A
000000000000000000000000000000000000001B0000001314141A1A1A1A1A1A1A1A1A1E00000000000000771478A2000000A20000C2001A00000000001C
000000000000000000000000000000000000001A7700001479771A1A1A1A1A1A1A1A1A1D383838383838383838383838383838383838383838383838381D
0000000000000000000000000000000000001A1A7900000000001B1A1A1A1A1A1A1A1A1C0000000000000000A2000077137900A20000001A00000000001E
00000000000000000000000000000000001A1A0000B2000000741A1A1A1AD21A1A1A1A1A880000881A00000000000000000000000000741A79000000001A
000000000000000000000000000000001A1A790000000000771A1A1A1A1A331A1A1B1A1A1A1A511A1A1A1A1A1A1A1A1A1A141A1A1A1A1A1A8300D300831A
000000000000000000000000001A1A1A1A1479000000B1771A1A1A1A1A1A7400000079791A8000801AA1A1A1C1C11A7A7A70741A1717171A83000070831A
000000000000000000000000001A8371751414000000001A1A1A1A1A1A1A0000C200C200000000001A1A1A1A1A1A1A1A1A1A1A1A1717171A1A1A541A1A1A
000000000000000000000000001B79000000000000001A1A1A1A1A1A140000000000000000B000001B17171717171718171817181717171A1A800083831A
000000000000000000000000001A77000000D0000079801A1A1A1A1A1400A200A2001300000000831A1717171717797779747779771717171A1A0000831A
000000000000000000000000001B7700D0160000001A1A1A1A1A1A1A1400000000001314777783831A1717170000000000000000000000171A1AA000001A
000000000000000000000000001A7900000000001A1A1A1A1A1A1A1A1A1A511A1A1A1A1A1A1B1A1A1A171700000000A00000B20000000000171A0073801A
000000000000000000000000001A7A7A000000881A1A1A1A1A1A1A80000000801A17171717171717171717000000000000D3000000000000171A1A231A1A
000000000000000000000000001A221A541A221A1A1A1A1A1A797A0000D000771A171717171717171717000000147100C100000013130079771700000000
000000000000000000171717171717170017171717171A1A1A777500A100A1791A1717171717171717170000001414000000A000137A0079771700000000
00000000000000000017171717740000000000837917171A1A1A1A88000000881A1717171717171717170000000000000074000000000000001900000000
000000000000000000171717830000A200000000000017171A1A1A1A1A001A1A1A17171717171919191700A00000B20017331700A000B200001700000000
171717181718171817171783830000007979A20000000017171719171753171719171775707A77797950000000D3C1753381337400D30000721900000000
17790000000000000017800000001414141414140000008817C200147900000000B0000000171919191700A00000000017331700C100B200001700000000
17740000A1001700001700C30000147775C2A2137700C3001700001477000000000000B0001700000017000000000000007400000000A077791900000000
178800C1000043790053000000001479B2C2A21377000000540000131300A30000001717171700000017000000217AA00000000020200077791700000000
17170000C17743B200170000000014141414141400C30000170000A300000000837917000000000000171700002121000000B2007A200000171700000000
001700000077430089178000C3000000207900000000008817880000000000838374170000000000001717000000000000D3000000000000171700000000
0025255225251717171717000000A2000000000000000017171718171817181717171700000000000017171700000000C10000A000000017171700000000
00250000002500000000171789000000000000A2008917170000000000000000000000000000000000171717171777797774777977171717171700000000
0025000000250000000017171789050505050505891717170000000000000000000000000000000000171717171717181718171817171717171700000000
0025252625250000000017171717323131313130171717170000000000000000000000000000000000000000000000000000000000000000000000000000
0000000000000000000017171717171717171717171717170000000000000000000000000000000000000000000000000000000000000000000000000000
0000000000000000000000000000000000000000000000000000000000000000000000000000000000000000000000000000000000000000000000000000
0000000000000000000000000000000000000000000000000000000000000000000000000000000000000000000000000000000000000000000000000000
0000000000000000000000000000000000000000000000000000000000000000000000000000000000000000000000000000000000000000000000000000
0000000000000000000000000000000000000000000000000000000000000000000000000000000000000000000000000000000000000000000000000000
0000000000000000000000000000000000000000000000000000000000000000000000000000000000000000000000000000000000000000000000000000
0000000000000000000000000000000000000000000000000000000000000000000000000000000000000000000000000000000000000000000000000000
0000000000000000000000000000000000000000000000000000000000000000000000000000000000000000000000000000000000000000000000000000
0000000000000000000000000000000000000000000000000000000000000000000000000000000000000000000000000000000000000000000000000000
0000000000000000000000000000000000000000000000000000000000000000000000000000000000000000000000000000000000000000000000000000
0000000000000000000000000000000000000000000000000000000000000000000000000000000000000000000000000000000000000000000000000000
0000000000000000000000000000000000000000000000000000000000000000000000000000000000000000000000000000000000000000000000000000
0000000000000000000000000000000000000000000000000000000000000000000000000000000000000000000000000000000000000000000000000000
0000000000000000000000000000000000000000000000000000000000000000000000000000000000000000000000000000000000000000000000000000
0000000000000000000000000000000000000000000000000000000000000000000000000000000000000000000000000000000000000000000000000000
0000000000000000000000000000000000000000000000000000000000000000000000000000000000000000000000000000000000000000000000000000
0000000000000000000000000000000000000000000000000000000000000000000000000000000000000000000000000000000000000000000000000000
0000000000000000000000000000000000000000000000000000000000000000000000000003030300000000000000000000000000000000000000000000
0000000000000000000000000000000000000000000000000000000000000000000000000003000001020200000000000000000000000000000000000000
0000000000000000000000000000000000000000000000000000000000000000000000000000040400020200000000000000000000000000000000000000
0000000000000000000000000000000000000000000000000000000000000000000000000000000000000000000000000000000000000000000000000000
0000000000000000000000000000000000000000000000000000000000000000000000000000000000000000000000000000000000000000000000000000
0000000000000000000000000000000000000000000000000000000000000000000000000000000000000000000000000000000000000000000000000000
0000000000000000000000000000000000000000000000000000000000000000000000000000000000000000000000000000000000000000000000000000
0000000000000000000000000000000000000000000000000000000000000000000000000000000000000000000000000000000000000000000000000000
0000000000000000000000000000000000000000000000000000000000000000000000000000000000000000000000000000000000000000000000000000
000000000000000000000000000000000000000000000000000000000000000000000000000A0A0A00000000000000000000000000000000000000000000
00000000000000000000000000000000000000000000000000000000000000000000000000000900000000000000000000000E0E0E0E0E00000000000000
000000000000000000000000000000000000000000000000000000000000000000000000000000000000000000000000000000000D000000000000000000
000000000000000000000000000000000000000000000000000000000000000000000000000000000B00000000000000000000000D000000000000000000
000000000000000000000000000000000000000000000000000000000000000000000000000000000B00000000000000000000000D000000000000000000
000000000000000000000000000000000000000000000000000000000000000000000000000000000B00000000000000000000000D000000000000000000
000000000000000000000000000000000000000000000000000000000000000000000000000000000000000000000000000000000D000000000000000000
00000000000000000000000000000000000000000000000000000000000000000000000000000000000C0C0C0C0C0000000F000000000000000000000000
0000000000000000000000000000000000000000000000000000000000000000000000000000000000000000000000101010100000000000000000000000
0000000000000000000000000000000000000000000000000000000000000000000000000000000000000000000000000000000000000000000000000000
0000000000000000000000000000000000000000000000000000000000000000000000000000000000000000000000000000000000000000000000000000
0000000000000000000000000000000000000000000000000000000000000000000000000000000000000000000000000000000000000000000000000000
0000000000000000000000000000000000000000000000000000000000000000000000000000000000000000000000000000000000000000000000000000
0000000000000000000000000000000000000000000000000000000000000000000000000000000000000000000000000000000000000000121200000000
0000000000000000000000000000000000000000000000000000000000000000000000000000000000000000000000000000000000000000000000110000
0000000000000000000000000000000000000000000000000000000000000000000000000000000000000000000000000000000000000000000000000000
0000000000000000000000000000000000000000000000000000000000000000000000000000000000000000000000000000000000000000000000000000
0000000000000000000000000000000000000000000000000000000000000000000000000000000000000000000000000000000000000000000000000000
0000000000000000000000000000000000000000000000000000000000000000000000000000000000000000000000000000000000000000000000000000
0000000000000000000000000000000000000000000000000000000000080000000000000000000000000000000000000000000000000000000000000000
0000000000000000000000000000000000000000000000000000000000000000000000000000000000000000000000000000000000000000000000000000
0000000000000000000000000000000000000006000000070000000000000000000000000000000000000000000000000000000000000000000000000000
0000000000000000000500000000000000000006000000070000000000000000000000000000000000000000000000000000000000000000000000000000
0000000000000000000000000000000000000000000000070000000000000000000000000000000000000000000000000000000000000000000000000000
0000000000000000000000000000000000000000000000000000000000000000000000000000000000000000000000000000000000000000000000000000
0000000000000000000000000000000000000000000000000000000000000000000000000000000000000000000000000000000000000000000000000000
0000000000000000000000000000000000000000000000000000000000000000000000000000000000000000000000000000000000000000000000000000
0000000000000000000000000000000000000000000000000000000000000000000000000000000000000000000000000000000000000000000000000000
0000001300000000000000000000000000000000000000000000000000000000000000000000000000000000000000000000000000000000000000000000
0000000000000000000000000000000000000000000000000000000000000000000000000000000000000000000000000000000000000000000000000000
