30250805
00000000000000000000000000000000252526252500000000000000000000000000000000
00000000000000000000000000000000250000002500000000000000000000000000000000
00000000000000000000000000000000250000002500000000000000000000000000000000
1A1A1A1A1B1A1A1A1B1A1A1A1B1A1A1A25255425251A1A1A1B1A1A1A1B1A1A1A1A1A1A0000
1A893300D3000000000074131313130000000000000000C0838300000000147777751A0000
1A8933000000A30000000000007A140014000000C200000000A30000000000147A7A1A0000
1A89338C000072008C00A300C0000000008C00007777778C000000C000A28C7A13711A0000
1B331A0000C00000A200000000A37400000000000000A30074130000A300000070141A0000
1A700000C20079797900C000000089000000000089C0007A131414000000000000001B0000
1A000000000018171719171719171800000000001A1A1A1A1A1A1A1A1A00741300791A0000
1B8200007A891783838300000000890000B2000089797979008888881AC00014A3791A0000
1A770000141317837A00000000000000000000000000000000007A881A80000000791B0000
1A77A300741419830000B2D00000140000B20000C30000D01F0000881B80A28CC2001A0000
1B7700000000170077008C00000014000000000000000000008C00001A8000A300C01A0000
1AC0008C00C0170077B200000014141400000013131313B20000B2001A22007400001B0000
1A00A200A20019007714141414141414000000137175140000D000001B220000A3001A0000
1B0000C2000017000000D000001414140000001313131300000000001A2200C000001A0000
1A00A200C089188900000000007777770000007979790000000000891A89000000001B0000
1A2121200000000000220000000000000071000000000000000000001A00000000001A0000
1B2000000000000000228800000000001A1B1A0000000000000000838300000000771A0000
1A21008C00B200B20022220000851A1B1A1A1A1B1A850000202079008383008C00771B0000
1A2174000000000000000000000000001A1B1A000000000088207900838300C200771A0000
1B2021000000000000000000C3000000007F0000000000C3002079001500000000001A0000
1A80000000891A8900000000007979790000007777770000000000891589000000001A1A1A
1A7A000000791A000000D0000013131300000014141400D00000000015000074C00530891A
1B0000A1C0791B79001313131313131300750014141414141400B20016A2008C140531891A
1AC0001400791A79B20000B20013131300B200141414B200000000001500C013140531891A
1A0000A200C21A79001F8C000000130000000000140000008C001533150000007A0531891A
1B00008C00001B000000D0000000130000000000140000D00000338115A200A2A20531891A
1A00C000A1001A837A000000C300000000B2000000C300000000338115000000000531891A
1A00000000801A8383830000000089000000000089008383007A3381158377C0000532891A
1B74000014131A1A1A1B1A1A1B1A1A75008C797915151615151615151583770000001A1A1A
1A000000001413897777777700008900000077771500A20000000083838300C200791B0000
1A770000007A140000C00000A2000000797977771500000000C000740000000000791A0000
1B77C08C00A100000000008C00000015151615151500C28C00A2200000A3008C00001A0000
1A7700000000C000A27400A100000080000000800000000000A200C0000000C000701A0000
1A8870000000000079797900000000000000000000007777770000797979790000881A0000
1A1A1B1A1A1B1A1A1B1A1A1B1A1A1A77008C00791A1A1A1B1A1A1B1A1A1B1A1A1A1A1A0000
00000000000000000000000000001A77007500791A00000000000000000000000000000000
00000000000000000000000000001B77000000791B00000000000000000000000000000000
00000000000000000000000000001A7A0000007A1A00000000000000000000000000000000
00000000000000000000000000001A88000000881A00000000000000000000000000000000
00000000000000000000000000001A1A1A541A1A1A00000000000000000000000000000000
00000000000000000000000000001A89790077891A00000000000000000000000000000000
00000000000000000000000000001B79790077771B00000000000000000000000000000000
00000000000000000000000000001A7A0000007A1A00000000000000000000000000000000
00000000000000000000000000001A88750171881A00000000000000000000000000000000
00000000000000000000000000001A1A1A1A1A1A1A00000000000000000000000000000000
00000000000000000000000000000000000006000000000000000000000000000000000000
00000000000000000000000000000000000000000000000000000000000000000000000000
00000000000000000000000000000000000000000000000000000000000000000000000000
00000000000000000000000000000000000001000000000000000000000000000000000000
00000000000000000000000000000000000000000000000000000000000000050505000000
00000000000000000000000000000000000000000000000000000000000000000505000000
00000000000000000000000000000000000000000000000000000000000000000405000000
00000000000000000000000000000000000000000000000000000000000000000000000000
00000000000000000000000000000000000000000000000000000000000000000000000000
00000000000000000000000000000000000000000000000000000000000000000000000000
00000000000000000000000000000000000000000000000000000000000000000000000000
00000000000000000000000000000000000000000000000000000000000000000000000000
00000000000000000000000000000000000000000000000000000000000000000000000000
00000000000000000000000000000000000000000000000000000000000000000000000000
00000000000000000000000000000000000000000000000000000000000000000000000000
00000000000000000000000000000000000000000303020000000000000000000000000000
00000000000000000000000000000000000000000000000000000000000000000000000000
00000000000000000000000000000000000000000000000000000000000000000000000000
00000000000000000000000000000000000000000000000000000000000000000000000000
00000000000000000000000000000000000000000000000000000000000000000000000000
00000000000000000000000000000000000000000000000000000000000000000000000000
00000000000000000000000000000000000000000000000000000000000000000000000000
00000000000000000000000000000000000000000000000000000000000000000000000000
00000000000000000000000000000000000000000000000000000000000000000000000000
00000000000000000000000000000000000000000000000000000000000000000000000000
00000000000000000000000000000000000000000000000000000000000000000000000000
00000000000000000000000000000000000000000000000000000000000000000000000000
00000000000000000000000000000000000000000000000000000000000000000000000000
00000000000000000000000000000000000000000000000000000000000000000000000000
00000000000000000000000000000000000000000000000000000000000000000000000000
00000000000000000000000000000000000000000000000000000000000000000000000000
00000000000000000000000000000000000000000000000000000000000000000000000000
00000000000000000000000000000000000000000000000000000000000000000000000000
00000000000000000000000000000000000000000000000000000000000000000000000000
00000000000000000000000000000000000000000000000000000000000000000000000000
00000000000000000000000000000000000000000000000000000000000000000000000000
00000000000000000000000000000000000000000000000000000000000000000000000000
00000000000000000000000000000000000000000000000000000000000000000000000000
00000000000000000000000000000000000000000000000000000000000000000000000000
00000000000000000000000000000000000000000000000000000000000000000000000000
00000000000000000000000000000000000000000000000000000000000000000000000000
00000000000000000000000000000000000000000000000000000000000000000000000000
00000000000000000000000000000000000000000000000000000000000000000000000000
00000000000000000000000000000000000000000000000000000000000000000000000000
00000000000000000000000000000000000000000000000000000000000000000000000000
00000000000000000000000000000000000000000000000000000000000000000000000000
00000000000000000000000000000000000000000000000000000000000000000000000000
00000000000000000000000000000000000000000000000000000000000000000000000000
