272E0000
00000000000000000000000000000000000000001717171717000000000000000000000000000000000000000000
0000000000000000000000000000000000000000177A717517000000000000000000000000000000000000000000
00000000000000000000000000000000000000001717001717000000000000000000000000000000000000000000
00000000000000000010102C1010102C101017171917171719171717191717171917171718191717171719171717
00000000000000000010D3C0007A00C0B2102D000000000000760000000043A20013131775760013148080803017
2525252510101010102C000000000000002C19C07713130000148C83000043B00070141778A10000000000003117
25000025131413141310880079817700001017171717170000B00000B00043A000797517141400B000A18C003117
26700050008C748C0051000081818100000053C07980170017421717421717171717171700000000001313C03117
25000025141314131410880077817900001017760000000000000000000000131400005100008C20001413C03117
2525252510101010102C000000000000002C1976008C00D020208CA00083008C0000C317A1002020770000003117
00000000000000000010B0C0007500C0D310178083838300000000008383A300008374170000767600788C783117
00000000000000000010102C1010102C101017171917171719170017171717171717171783000000B01413143117
00000000000000000000000000001A1A1A1A1A1A1B1A1A1A1B1A511A1B1A1A1A1B1A1A1783837700000000003217
00000000000000000000000000001A75A1A11A8000000083838300000000000000801A1717171717171717511717
00000000000000000000000000001A79C0C01B008C20000000008C00000000008C001B1783777580171314008019
00000000000000000000000000001A70D0D01A007920000000C30000C300001313771A17777979B0171400000017
00000000000000000000000000001A77B1B11A0000890000000000000000000013001A17A0A08CB0178000000017
00000000000000001A1A1A1A1A1A1A1A1A1A1B000000001A1A1A501A1A1A000000001B1717171717170000A3A319
00000000000000001A893305C083838374881A000000001A130000007D1A830000B01A1700000000000000218317
00000000000000001A89330500008C00000051008CA1831A14008C00141A83008C005100008C000000008C217417
00000000000000001A8933050000000000881A00A183831A74000100131A000000001A170000C11A411A0021C117
00000000000000001A8933057720200000001B000000001A1A1A1A1A1A1A000000001B1900200041814100007919
00000000000000001A893305000000A3A3001A0000000000000000000000000000001A170000D11A411AD1131417
00000000000000001A8933052100002020001A0000D02100000083830000891400001A1780007778727800131417
00000000000000001A8933057900000000001B008C7A218900008C83000014B08C831B17171719172D1719171717
00000000000000001A893305C00000B0B0001A800000D000000000000000000000751A0000000000000000000000
000000000000001A1A1A1A1B21008C1314131A1A1B1A1A1A1B1A541A1B1A1A1A1B1A1A0000000000000000000000
000000000000001A1A8000002100001375771A818181811A77880088701AA0C1B0D01A0000000000000000000000
000000000000001A3200D000000000137A7A1A333333331A790000A1751A777476791A0000000000000000000000
000000000000001A31008C001A1A1A1A1A1A1A050505051A00D08C14141A1A1A1A1A1A0000000000000000000000
000000000000001A3100000000891A8077801A800000771B00000083131A00000000000000000000000000000000
000000000000001B3100007900001A008C00000000C1C11A001A0079131A1A1A1A1A000000000000000000000000
000000000000001A3100A380A3001A0000001A800000C100001A0000131A1A79751A000000000000000000000000
000000000000001A3100131413001A0083B01A8300008C000040B0008C1A0079701A000000000000000000000000
000000000000001A300076797600000083741A8383131314141A8073801A1A777A1A000000000000000000000000
000000000000001A1A40404040401A1A1A1A1A1A1A1A1A1A1A1A1A231A1A1A1A1A1A000000000000000000000000
00000000000000001AB0A0B0A0B01A00000000000000000000000000000000000000000000000000000000000000
00000000000000001A00000000001A00000000000000000000000000000000000000000000000000000000000000
00000000000000001A1A1B1A1B1A1A00000000000000000000000000000000000000000000000000000000000000
00000000000000000000000000000000000000000000000000000000000000000000000000000000000000000000
00000000000000000000000000000000000000000000000000000000000000000000000000000000000000000000
00000000000000000000000000000000000000000000020000000000000000000000000000000000000000000000
00000000000000000000000000000000000000000000010000000000000000000000000000000000000000000000
00000000000000000000000000000000000003000000000000000000000004000000000000000000000000000000
00000000000000000000000000000000000000000000000000000000000004000000000000000000000000000000
00000000000000000000000000000000000000000000000000000000000004000000000000000000000000000000
12000000000000000000000000000000000008000000000000000000000000000000000000000000000000000000
00000000000000000000000000000000000000000000000000000000000000000000000000000000000000000000
00000000000000000000000000000000000000000000000000000000000000000000000000000000000000000000
00000000000000000000000000000000000000000000000000000000000000000000000000000000000000000000
00000000000000000000000000000000000000000000000000000000000000000000000000000000000000000000
00000000000000000000000000000000000000000000000000000000000000000000000000000000000000000000
0000000000000000000000000000000000000D000000000000000000000000000000000000000000000000000000
0000000000000000000000000000000000000D000000000000000000000000000000000000000000000000000000
0000000000000000000000000000000000000D000000000000000000000000000000000000000000000000000000
0000000000000000000000000000000000000D000000000000000000000000000000000000000000000000000000
0000000000000000000000000000000000000000000000000000000000000000000000000A0A0A0A000000000000
00000000000000000000000000000000000000000000000000000000000000000000000000000000000000000000
00000000000000000000000000000000000007000000000000000000000000000000060000000000000000000000
00000000000000000000000000000000000000000000000000000000000000000000000000000000000000000000
00000000000000000000000000000000000000000000000000000000000000000000000000000000000000000000
00000000000000000000000000000000000000000000000000000000000000000000000000000000000000000000
00000000000000000000000000000000000000000000000000000000000000000000000000000009090900000000
00000000000000000000000000000000000000000000000000000000000000000000000000000000050000000000
00000000000000000000000000000000000000000000000000000000000000000000000000000000000000000000
000000000000000000000000000000000E0000000000000000000B0000000D0D0D0D000000000000000000000000
000000000000000000000000000000000F0F00000000000000000000000000000000000000000000000000000000
000000000000000000000000000000000F0F00000000000000000000000000000000000000000000000000000000
00000000000000000000000000000000000000000000000000000000000000000000000000000000000000000000
00000000000000000000000000000000000000000000000000000000000000000000000000000000000000000000
00000000000000000000000000000000000000000000000000000000000000000000000000000000000000000000
00000000000000000000000000000000000000000000000000000000000000000000000000000000000000000000
00000000000000000000000000000000000000000000000000000000001011000000000000000000000000000000
00000000000000000000000000000000000000000000000000000000000000000000000000000000000000000000
0000000000000000000000000000000000000000000000000000000C000000000000000000000000000000000000
00000000000000000000000000000000000000000000000000000000000000000000000000000000000000000000
00000000000000000000000000000000000000000000000000000000000000000000000000000000000000000000
00000000000000000000000000000000000000000000000000000000000000000000000000000000000000000000
