1E240000
00000000000000000000000000001A1A1B1A1A0000000000000000000000000000000000
00000000000000000000000000001A74037A1A0000000000000000000000000000000000
00000000000000000000000000001A008C001A0000000000000000000000000000000000
00000000000000000000000000001A0000001A0000000000000000000000000000000000
25252625250000000000000000001A1A501A1A0000000000000000000000000000000000
25007A00250000000000000000001A3200301A0000000000000000000000000000000000
25008C00250000000000000000001A318C311A0000000000000000000000000000000000
25800080250000000000000000001A31C1311A0000000000000000000000000000000000
25255025250000000000000000001A30A0321A0000000000000000000000000000000000
00100010101010102C1010101A1A1A1A511A1A1A1A1B1A1A1B1A1A1A1A1B1A1A1A1A0000
00100000C1420000000074101A80000000801A80B000000079801A807900710074230000
002C0000004200000083832C1B77008C00001B00008C000000001A77008C83831A1A0000
00100000A21000A1A17983101A0000C0D0C01A000000748300D0510000007E791A000000
00108077B051D020200031101A00000000001A000080838300001A00A0C100781A000000
0010102C101000008C0031101B79008C00001B00001A1A7700001B00000000771B000000
00000000002C0000000031101A83B00000001A000000A1008C001A00000000831A000000
00000000001083C3C37780101A838300000000000000000000A141A0008C00791A000000
0000000000108000001010101A1A1A1B1A1A1B1A1A1B1A1A1B1A1A33333333331A000000
0000000000101010511010101010101010101A1A1A1A231A1A1A1A05050505051A000000
0000000000108300003131313131313132101A8383D0D083831A1AD0D0D0D0D31A1A1A1A
000000000010B0000000000000A2A20070101A838C00008C831A1BC3C3C3C3C11B74711A
00000000002C00002121790021424221002C1B7900002200771B1A89008C00001A79771B
0000000000108300210000000000000000101A0000767676001A1000002079001A008C1B
0000101010108300770000333333333300101AC1C11A1A1A001A1A89792076001AC3D01A
0000100000107900180000330505053300101A00741B7A1BA31A1A76002076001A1A1A1A
0000107A752C00A24200853305B00533C12C1B00001A1A1AA31B1B00007500001B000000
00001010101000A2420000330505053300101A0000000000001A1A00008C00801A000000
00000000001000001800003333333333000051B18C00208C0051B000000083831A000000
0000000000108075000000D0000000C100101A8078780000801A1A800000B07A1A000000
000000000010102C1010102C1010102C10101A1A1A1A1A1A1A1A1A1A1A1B1A1A1A000000
000000000000000000000000000000000000000000000000000000000000000000000000
000000000000000000000000000000000000000000000000000000000000000000000000
000000000000000000000000000000000000000000000000000000000000000000000000
000000000000000000000000000000000000000000000000000000000000000000000000
00000B000000000000000000000000000000000000000000000000000000000000000000
000000000000000000000000000000000000000000000000000000000000000000000000
000000000000000000000000000000000000000000000000000000000000000000000000
000000000000000000000000000000000000000000000000000000000000000000000000
000000000000000000000000000000000000000000000000000000000000000000000000
000000000000000000000000000000000000000000000000000000000000000000000000
000000000000000000000000000000000000000000000000000000000000000000010000
000000000000000000000000000000000000000000000000000000000000000000000000
000000000000000000000000000000000000000000000000000000000000000000000000
000000000000000000000000000000000000000000000000000000000000000000000000
000000000000000000000000000000000000000000000000000000000000000000000000
000000000000000000000000000000000000000000000000000000000000000000000000
000000000000000000000000000000000000000000000000000000000000000000000000
000000000000000000000000000000000000000000000000000000020202020200000000
000000000000000000000000000000000000000000000700000000000000000000000000
000000000000000000000000000000000000000000000000000000000000000000000000
000000000000000000000000000000000000000000000000000000000000000000000000
000000000000000000000000000000000000000000000000000000000000000000000000
0000000000000000000000000000000000000000000000000000030000000000040C0000
000000000000000000000000000000000000000000000000000000000000000000000000
00000000090A000000000000000000000000000000000600000000000000000000000000
000000000000000000000000000000000000000000000500000000000000000000000000
000000000000000000000000000000000000000000000000000000000000000000000000
000000000000000000000000000000000000080000000000000000000000000000000000
000000000000000000000000000000000000000000000000000000000000000000000000
000000000000000000000000000000000000000000000000000000000000000000000000
