30370206
00000000000000000000000000000000000000001A1A1C1D1E1A1A00000000000000000000000000000000000000000000000000000000
00000000000000000000000000000000000000001A80000300801A00000000000000000000000000000000000000000000000000000000
00151516151615161516151515151515151515151B00000000001B00000000000000000000000000000000000000000000000000000000
0015791400000000000000801574790015A2C1161A747700797A1A00000000000000000000000000000000000000000000000000000000
001600000000B000000000005170000015A2C1161A1A1A511A1A1A00000000000000000000000000000000000000000000000000000000
001500001B40401B000000801500000015A2C1161A83000000831A00000000000000000000000000000000000000000000000000000000
001500B0007977000000151515001677151515151B00000000001B00000000000017171719181917171700000000000000000000000000
15150000007A7500A100151300000079151515151A79A10000001A000000000017178000B3000000791717171717170000000000000000
158300001B40401B00001600C1C10000151581811A14130000001A171918191717770000000000000017B1B15100170000000000000000
168300A00000A1000077150000001600801533331A7A1400A1001A17880000000000001900001900001733331700171700000000000000
158300000000000000151574830000B20000050551A10000000051000000000000A300007D7500B3001705050000881719181917000000
1515158800C000C08815777983000000801515151A00001313001A178800A313130000190000190000540000A300000000007417170000
0000151515155115151515151515151515151A1A1A00C17414001A1719181917140000000000000080170000000000A300000000170000
0000001515800000A3000000001377151A1A231A1A000000C1001A1A231A1A17790000C300007717171719431917000000000000171717
000000157400000000050500A30077151AD372D31A00000000771A75737A1A178000000000801717807777770017000013777700008917
000000157900A3001A33331A000077151A7A00751A1A1A531A1A1AD200D31A17171754171717178000C300C30017000013141300C17117
00000015150000053385853305000000517900771A1A7A757A1A1A7900771A17880000000088170000741900001700C179141400008917
000000153200000533858533050079151A7900771A1B7970771B1A7900771A18000000B200005400C300C300A254000079137A00001717
000000153100C1001A33331A00B179151A7900771A1A79D2771A1A7900771A190000000000001700797979801717000000000000001800
00000015300000A3000505C1007915151A1A1A1A1A1A1A531A1A1A1A541A1A1800B20000C100171719181917171783830000B100001900
0000001515157779741515151515150000000000001A8838881A171700171717740000002200001700000000001717830000007A051800
0000000000151515151500000000000000000000001A0038001A178000797913131300A200000014000000000000171718191817331700
0000000000000000000000000000000000000000001B0038001B1780000000777714000020000014141414000000000000000017811700
0000000000000000000000000000000000000000001A0038001A17177900A0000000000020A20013707A14000000000000000017171700
0000000000000000000000000000000000000000001B0038001B00171777000000C100A000007917757A14000000000000000000000000
0000000000000000000000000000000000000000001A0038001A0000171700000000000000771717141414000000000000000000000000
0000000000000000000000000000000000000000001B0038001B0000001717191819181918191700000000000000000000000000000000
00000000000000000000000000001A1A1A1A1A1A1A1A0038001A1A1A1A1A1A1A1A00000000000000000000000000000000000000000000
00000000000000000000000000001A7783000000000000380000000000B183831A00000000000000000000000000000000000000000000
00000000000000000000000000001AB100000500A100003800000000050079831A00000000000000000000000000000000000000000000
00000000000000000000000000002300001A331A000000380000001A331A00002300000000000000000000000000000000000000000000
0000000000000000000000001A1A1A00053381330500003800000533873305001A1A1A1A1A1A1A00000000000000000000000000000000
0000000000000000000000001A753305001A331A000013381400001A331A000533751AA3C3771A00000000000000000000000000000000
0000000000000000000000001A7A330500740500A10013381400A10005000005337A1AA3C3771A00000000000000000000000000000000
0000000000000000000000001A7933050000050000001338140000000574000533771AA3C3791A00000000000000000000000000000000
0000000000000000000000001A793305001A331A000013381400001A331A000533771AA3C3791A00000000000000000000000000000000
0000000000000000000000001A1A1A000533873305007A387A000533813305001A1A1A1A1A1A1A00000000000000000000000000000000
00000000000000000000000000001A00001A331A000000380000001A331A00001A00000000000000000000000000000000000000000000
00000000000000000000000000001A0000B1050000A10038000000000500B1001A00000000000000000000000000000000000000000000
00000000000000000000000000001A8800000000000000380000A100000000881A00000000000000000000000000000000000000000000
00000000000000000000000000001A1A1A1A1A1A1A25255225251A1A1A1A1A1A1A00000000000000000000000000000000000000000000
00000000000000000000000000001AA3A3A3A01A0025777479250000000000000000000000000000000000000000000000000000000000
00000000000000000000000000001AC3C3C3C31A0025777479250000000000000000000000000000000000000000000000000000000000
00000000000000000000000000001A7779747A1A0025252625250000000000000000000000000000000000000000000000000000000000
00000000000000000000000000001A141413141A0000000000000000000000000000000000000000000000000000000000000000000000
000000000000000000000000000000147A7514000000000000000000000000000000000000000000000000000000000000000000000000
00000000000000000000000000000014797714000000000000000000000000000000000000000000000000000000000000000000000000
00000000000000000000000000000014141414000000000000000000000000000000000000000000000000000000000000000000000000
00000000000000000000000000000000000000000000000000000000000000000000000000000000000000000000000000000000000000
00000000000000000000000000000000000000000000000000000000000000000000000000000000000000000000000000000000000000
00000000000000000000000000000000000000000000000000000000000000000000000000000000000000000000000000000000000000
00000000000000000000000000000000100000000000000000000000000000000000000000000000000000000000000000000000000000
0000000000000000000000000F000000100000000000000000000000000000000000000000000000000000000000000000000000000000
00000000000000000000000000000000100000000000000000000000000000000000000000000000000000000000000000000000000000
00000000000000000000000000000000000000000000000000000000000000000000000000000000000000000000000000000000000000
00000000000000000000000000000000000000000000000000000000000000000000000000000000000000000000000000000000000000
00000000000000000000000000000000000000000000000000000000000000000000000000000000000000000000000000000000000000
00000000000000000000000000000000000000000000000000000000000000000000000000000000000000000000000000000000000000
00000000000000000000000000000000000000000000000000000000000000000000000000000000000000000000000000000000000000
00000000000000000000000000000000000000000000000000000000000000000000000000000000000000000000000000000000000000
00000000000000000000000000000000000000000000000000000000000000000000000000000000000000000000000000000000000000
00000000000000000000000000000000000005000000000000000000030000000000000000000000000000000000000000000000000000
00000000000000000000000000000000000000000600000000000400000000000000000000000000000000000000000000000000000000
00000000000000000000000000000000000000000000000100000000000000000000000000000000000000000000000000000000000000
00000000000000000000000000000000000000000000000000000000000000000000000000000000000000000000000000000000000000
00000000000000000000000000000000000000000000000000000000000000000000000000000000000000000000000000000000000000
00000000000000000000000000000000000000000000000000000000000000000000000000000000000000000000000000000000000000
00000000000000000000000000000000000000000000000200000000000000000000000000000000000000000000000000000000000000
00000000000000000000000000000000000000000000000000000000000000000000000000000000000000000000000000000000000000
00000000000000000000000000000000000000000000000000000000000000000000000000000000000000000000000000000000000000
00000000000000000000000000000000000000000000000000000000000000000000000000000000000000000000000000000000000000
00000000000000000000000000000000000000000000000000000000000000000000000000000007080800000000000000000000000000
00000000000000000000000000000000000000000000000000000000000000000000000000000000080800000000000000000000000000
00000000000000000000000000000000000000000000000000000000000000000000000000000000000000000000000000000000000000
00000000000000000000000000000000000000000000000000000000000000000000000000000000000000000000000000000000000000
00000000000000000000000000000000000000000000000000000000000000000000000000000000000000000000000000000000000000
00000000000000000000000000000000000000000000000000000000000000000000000000000000000000000000000000000000000000
00000000000000000000000000000000000000000000000000000000000000000000000000000000000000000000000000000000000000
00000000000000000000000000000B00000000000000000000000000000000000900000000000000000000000000000000000000000000
00000000000000000000000000000000000000000000000000000000000000000000000000000000000000000000000000000000000000
00000000000000000000000000000C00000000000000000000000000000000000A000A0000000000000000000000000000000000000000
00000000000000000000000000000C00000000000000000000000000000000000A000A0000000000000000000000000000000000000000
00000000000000000000000000000C00000000000000000000000000000000000A000A0000000000000000000000000000000000000000
00000000000000000000000000000C00000000000000000000000000000000000A000A0000000000000000000000000000000000000000
00000000000000000000000000000000000000000000000000000000000000000000000000000000000000000000000000000000000000
00000000000000000000000000000000000000000000000000000000000000000000000000000000000000000000000000000000000000
00000000000000000000000000000000000000000000000000000000000000000000000000000000000000000000000000000000000000
00000000000000000000000000000000000000000000000000000000000000000000000000000000000000000000000000000000000000
0000000000000000000000000000000C0C0C0C000000000000000000000000000000000000000000000000000000000000000000000000
00000000000000000000000000000000000000000000000000000000000000000000000000000000000000000000000000000000000000
00000000000000000000000000000000000000000000000000000000000000000000000000000000000000000000000000000000000000
00000000000000000000000000000000000000000000001100000000000000000000000000000000000000000000000000000000000000
00000000000000000000000000000000000D00000000000000000000000000000000000000000000000000000000000000000000000000
000000000000000000000000000000000E0E00000000000000000000000000000000000000000000000000000000000000000000000000
000000000000000000000000000000000E0E00000000000000000000000000000000000000000000000000000000000000000000000000
00000000000000000000000000000000000000000000000000000000000000000000000000000000000000000000000000000000000000
