2A3F0001
000000000000000000000000000000001515151615151622151615151615151615151500000000000000000000000000000000000000000000000000000000
0000000000000000000000000000000015838300C3000000000000000000000000001515150000000000000000000000000000000000000000000000000000
000000000000000000000000000000151583000000008C0000000000B30000008C000088150000000000000000000000000000000000000000000000000000
0000000015151516151500000000151589000000000000A1007914750000000083830000131313130000000000000000000000000000000000000000000000
000000151589000083151515151615000000151516151516151515151516151515830000130000130000000000000000000000000000000000000000000000
000000157900000000001515880000A30000158979007A00000015C2C20000791583B300140000130000000000000000000000000000000000000000000000
0000001575A2000000008815000000000000007977000000000015C2C200007915830000131313130000000000000000000000000000000000000000000000
000000151514008C0000005100001B000000007477007100007A15C2C275007A15000083150000000000000000000000000000000000000000000000000000
000000001502000000008815000000000000007977000000000015C2C200007715000083151515161515161515161515161515161515161515161515150000
000000001500000000001515880000A30000158979007A00000015C2C20000771500000015880000A2007914137400C2008383837900B100000000001C0000
00000000158900008315151515161500000015151615151615151515151615151500B3005138383838383838383838383838383838383838383838381D0000
0000000015151516151500000000150000000000000000A114790000000000000000000015880000000000A2000000000000000000000000000000001E0000
0000000000000000000000000000151589000000C3008C00000000B3000000008C00008815151516151500007405141400C200050000B17515155315150000
000000000000000000000000000000151500050505050505050505050505000000001515150000000015790015331500000015331500771515890089151515
0000000000000000000000000000000015153031313131313131313131321515161515000000000000157705338133057A053381330577151500000533D315
00000000000000000000000000000000001589898989898989898989898915000000000000000000001600001533150000001533150000161600700533D315
0000000000001A1A1A1B1A1A1A000000001515151515151515151515151515000000000000000000001500000005000000000005000000151500000533D315
00000000001A1A79000000001A1A00000000000000000000000000000000000000000025252625250015830000000079727700000000831515890089151515
00000000001A800000000000001A1A1A1A1A1A1A1A1A1A00000000000000000000000025797577250015151515151515151515151515151515155415150000
00000000001A0000791A00A1001A1A757779B1C3C3A31A00000000000000000000000025797A772500000015A3A2D2157F15D2A2A315001A1A1A001A1A0000
00000000001A00D37740000000801A1A1A1A1B1B1B1B1A1A1B1A1A1B1A1A1A00000000252553252500000015C37A74157915C37A7915001A880000881A0000
1A1A1A1A1A1A000074400022007A1B838300000000000000000074A200831A1A0000001A8800881A0000001515151515771515151515001BA30000001B0000
1A813305753305001A1A000000771A8300001B00A2001B0000001B000083831A0000001B0000001B00000000001500000015000000001A1A000000791A0000
1A81330573330500231B00000000510000007A0000797900A27777000000771A0000001A0000001A1A1B1A13131A14131A1A1A1A1A1A1A77008C001A1A0000
1A813305703305001A1A000000791A00A2001B0000001B0000001B0000A2001A1A1B1A1A008C000000000000831A00741A1AB333050000000077A31A000000
1A1A1A1A1A1A000074400022007A1B00000000000000740000000000000000740000801A0000001A00000000831A0000801A331A0000C200001A1A1A000000
00000000001A00D37740000000801A141313141A1B1B1B1B1A1A1A1A790000A20000005100D3004077A20000A2400000001B0500008C0000B21B0000000000
00000000001A8000791A00A1001A1A000000001AA3C3C3B17977701A1A7400000000801A8800004077002200794000A2001A00C200000000791A0000000000
00000000001A1A0000000000001A00000000001A1A1A1A1A1A1A1A1A1A1A1A1A1A1B1A1A1A531A1A83000000791A00000054000000001313141A0000000000
0000000000001A83000000001A1A0000000000000000000000000000000000000000001A8000801A83000000000000001A1A1A1B1A7479771A1A0000000000
0000000000001A1A1A1B1A1A1A000000000000000000000000000000000000000000001A7500791A1A1B1A1A74791A1B1A0000001A1A1B1A1A000000000000
00000000000000000000000000000000000000000000000000000000000000000000001B7700771B0000001A1A1A1A00000000000000000000000000000000
00000000000000000000000000000000000000000000000000000000000000000000001A7A007A1A0000000000000000000000000000000000000000000000
000000000000000000000000000000000000000000000000000000000000001A1A1B1A1A0000001A1A1B1A1A1A000000000000000000000000000000000000
00000000000000000000000000000000000000000000000000000000001A1A1A8000001A0000001A000000801A1A0000000000000000000000000000000000
00000000000000000000000000000000000000000000000000000000001A830000C2A21A0070001AA2C20000741A0000000000000000000000000000000000
00000000000000000000000000000000000000000000000000000000001B740000C2A21B0000001BA2C20000001B0000000000000000000000000000000000
00000000000000000000000000000000000000000000000000000000001A00008C14141A0000001A1313148C001A0000000000000000000000000000000000
00000000000000000000000000000000000000000000000000000000001A00000014141A887C881A74791400001A0000000000000000000000000000000000
00000000000000000000000000000000000000000000000000000000001B83B100007A1A1A1A1A1A000000B1001B0000000000000000000000000000000000
00000000000000000000000000000000000000000000000000000000001A83830000000000C20000000000007A1A0000000000000000000000000000000000
00000000000000000000000000000000000000000000000000000000001A1A1A1A1A1A1A1A1A1A1A1A1A1A1A1A1A0000000000000000000000000000000000
000000000000000000000000000000000000000000000000000000000000000000000000000000000000000000000000000000000000000000000000000000
000000000000000000000000000000000000000000000000000000000000000000000000000000000000000000000000000000000000000000000000000000
000000000000000000000000000000000000000000000000000000000000000000000000000000000000000000000000000000000000000000000000000000
000000000000000000000000000000000000000000000000000000000000000000000000000000000000000000000000000000000000000000000000000000
000000000000000000000000000000000000000000000000000000000000000000000000000505000000000000000000000000000000000000000000000000
000000000000000000000000000000000000000000010000000002000000000002000000040505000000000000000000000000000000000000000000000000
000000000000000000000000000000000000030000010000000002000000000002000000000000000000000000000000000000000000000000000000000000
000000000000000000000000000000000000030000010000000002000000000002000000000000000000000000000000000000000000000000000000000000
000000000000000000000000000000000000030000010000000002000000000002000000000000000000000000000000000000000000000000000000000000
000000000000000000000000000000000000000000010000000002000000000002000000000000000000000000000000000000000000000000000000000000
000000000000000000000000000000000000000000000000000000000000000000000000000000000000000000000000000000000000000000000000000000
000000000000000000000000000000000000000000000000000000000000000000000000000000000000000000000000000000000000000000000000000000
000000000000000000000000000000000000000000000000000000000000000000000000000000000000000000000000000000000000000000000800000000
000000000000000000000000000000000000000000000000000000000000000000000000000000000000000000000000000000000000000000000000000000
000000000000000000000000000000000000000000000000000000000000000000000000000000000000000000000000000000000000000000000000000000
000000000000000000000000000000000000000000000000000000000000000000000000000000000000060600000006060600000006060000000000000000
000000000000000000000000000000000000000000000000000000000000000000000000000000000000000000000000000000000000000000000000000000
000000000000000000000000000000000000000000000000000000000000000000000000001600000000000000000000000000000000000000000000000000
000000000000000000000000000000000000000000000000000000000000000000000000000000000000000007070700000007070700000000000000000000
0000000000000000000000000000000000000000000000000000000000000000000000000000000000000000000000000A0000000000000000000000000000
000000000000000000000000000000000000131313130000000000000000000000000000000C000000000000000000000A0000000000000000000000000000
0000000000000000000000000000000000000000000000001200100000000000000000000000000000000000000000000A0000000000000000000000000000
000000000015000000000000000000000000000000000000120000000000000000000000000000000000000000000A0A0A0000000000000000000000000000
000000000015000014000000000000000000000000000000120010000000000000000000000000000000000000000900000000000000000000000000000000
000000000015000000000000000000000000000000000000120000000000000000000000000000000000000000000000000000000000000000000000000000
000000000000000000000000000000000000000000000000120010000000000000000000000000000000000000000000000000000000000000000000000000
000000000000000000000000000000000000000011111111000000000000000000000000000000000000000000000000000000000000000000000000000000
000000000000000000000000000000000000000000000000000000000000000000000000000000000000000000000000000000000000000000000000000000
000000000000000000000000000000000000000000000000000000000000000000000000000B00000000000000000000000000000000000000000000000000
000000000000000000000000000000000000000000000000000000000000000000000000000000000000000000000000000000000000000000000000000000
000000000000000000000000000000000000000000000000000000000000000000000000000000000000000000000000000000000000000000000000000000
000000000000000000000000000000000000000000000000000000000000000000000000000000000000000000000000000000000000000000000000000000
000000000000000000000000000000000000000000000000000000000000000000000000000000000000000000000000000000000000000000000000000000
000000000000000000000000000000000000000000000000000000000000000000000000000000000000000000000000000000000000000000000000000000
00000000000000000000000000000000000000000000000000000000000000000000000F0D0D0D0F0000000000000000000000000000000000000000000000
00000000000000000000000000000000000000000000000000000000000000000000000F0000000F0000000000000000000000000000000000000000000000
00000000000000000000000000000000000000000000000000000000000000000000000F0000000F0000000000000000000000000000000000000000000000
0000000000000000000000000000000000000000000000000000000000000000000000000E0E0E000000000000000000000000000000000000000000000000
000000000000000000000000000000000000000000000000000000000000000000000000000000000000000000000000000000000000000000000000000000
000000000000000000000000000000000000000000000000000000000000000000000000000F00000000000000000000000000000000000000000000000000
000000000000000000000000000000000000000000000000000000000000000000000000000000000000000000000000000000000000000000000000000000
000000000000000000000000000000000000000000000000000000000000000000000000000000000000000000000000000000000000000000000000000000
