38320505
0000000017171918191819171717000000000000000000000000000000000000000000000000000000000000000000000000
000000171780000000000000771717000000000000000000000000000015151C1D1E15151515161515161515000000000000
00001717800000D2000000C00079171717171819181717000000000000157900387780157777000000C10015151615151500
1717178000D2000017C00000000079178800000000001717170000000015790038770054000000A100000083830075721500
17893305000075731900001900B1005400000071A100007718000000001500C2380080157900000014147700D000007A1600
1789330500171717177A00000000791700A10013140000001900000000150000381313157900B1007A137700000000001500
178933050079000000000000A00077188000801479C10000180000000015C2003800141515838300000000000000D0001500
17893305000000B174171717170077171819181700000017170000000015770038C214151515161515150013000000001600
171717000000190000197A000000001783777917000089170000000000157700380000150000000000150000000000791500
000017177900000000170000C000171774A100540000171700000000001514143800C21500000000001500C1008383791500
00000017177700A0000000C0001717000000801717171717171717170015751338C200150000000000160000131413001600
0000000017171779790077771717170000001717178187818781871700157A133800791500000000001500B1007A13001500
00000000001717171754171717A11700C200171A1A3231313131301A1A150000380079150000000015157700A10000001500
000000000017838300007717A1C017000000171A14050505050505131A1500C238C283150000000015897700007979701600
000000000019830000007017C0C0171700B1171A88000000B00000881A150000380083150000000015151515541515891500
0000000000170000B0001717171717177977005400001B00001B000054000000380083150015151515158800008815151515
00000000001700000000197A757977171717171A000000000000B0001A15151E1D1C15151515830000000000000000777715
00000000001900C10000171817171A1A1A1A1A1A890000B0000000891A1A1A1A1A1A1A1588770000A000C10000B000000015
00000000001700000000177988171A890077001A1A1A401A531A401A1A1A000077131A157900160000160000160000160015
00000000001717001743170000171A000000B000881A00007900001A8133050000001A1500000000001374B00000B0000015
00000000001977000000000000005400B0000000001B80007700801A331A0000C10054000000C10000140000000079791515
0000000017170000A200130088171A0000141314791A25255325251A0500000000801A1500000000000000C1151515151500
00000000178000140000A20017171B0000000000A11A25777579251A00A2000020201A15770016A000160015150000000000
000000001717000000000080171A1A00A100C300831B25777A79251A0000130000001A158879000000000015000000000000
000000000017171917171917171A7900007A0000831A25252625251A00A2000000001A151515151515151515000000000000
000000000000000000000000001B00C313141300001A1A1B1A1B1A1A7900000000001A1A0000000000000000000000000000
000000000000000000000000001A0000007700A1001A89000000831A1A1A1A00C100221A1A1A1A0000000000000000000000
000000000000000000000000001A00A200C300A1005100000000000000801A000000217579711A0000000000000000000000
000000000000000000000000001B000000141A1A1A1A00C100000000000051000000221A777A1A0000000000000000000000
000000000000000000000000001A890000771A8300000000000000C100801A1A1A1A1A1A1A1A1A0000000000000000000000
000000000000000000000000001A1A0000741A00A2000013131400771A1A1A1A000000000000000000000000000000000000
00000000000000000000000000001A1A1B1A1A00001300000013001A1A000000000000000000000000000000000000000000
00000000000000000000000000000000001A1A00000000A20000001A00000000000000000000000000000000000000000000
0000000000000000000000000000000000001A8300A200000000C11A00000000000000000000000000000000000000000000
0000000000000000000000000000000000001B83000000001314771B00000000000000000000000000000000000000000000
0000000000000000000000000000000000001A838300000013747A1A00000000000000000000000000000000000000000000
0000000000000000000000000000000000001A1A1A1A511A1A1A1A1A00000000000000000000000000000000000000000000
0000000000000000000000000000000000001A880000B00000881A1A1A1A1A00000000000000000000000000000000000000
0000000000000000000000000000000000001B00001B771B00001A00B0141A00000000000000000000000000000000000000
0000000000000000000000000000000000001A00A0000000A000510000751A00000000000000000000000000000000000000
0000000000000000000000000000000000001A000000C10000001A00B0701A00000000000000000000000000000000000000
0000000000000000000000000000000000001B00001B131B00001A83837A1A00000000000000000000000000000000000000
0000000000000000000000000000000000001AA20000000000A21A1A1A1A1A00000000000000000000000000000000000000
0000000000000000000000000000000000001A000000000000001A0000000000000000000000000000000000000000000000
0000000000000000000000000000000000001B00001B771B00001B0000000000000000000000000000000000000000000000
0000000000000000000000000000000000001A790000000000831A0000000000000000000000000000000000000000000000
0000000000000000000000000000000000001A1A0000C200001A1A0000000000000000000000000000000000000000000000
000000000000000000000000000000000000001A88000000881A000000000000000000000000000000000000000000000000
000000000000000000000000000000000000001A1A1A001A1A1A000000000000000000000000000000000000000000000000
0000000000000000000000000000000000000017171751171717000000000000000000000000000000000000000000000000
0000000000000000000000000000000000001717880000008817170000000000000000000000000000000000000000000000
0000000000000000000000000000000000001783000000000000170000000000000000000000000000000000000000000000
0000000000000000000000000000000000001983830000000074190000000000000000000000000000000000000000000000
0000000000000000000000000000000000001714140000000013170000000000000000000000000000000000000000000000
0000000000000000000000000000000000001714130001007713170000000000000000000000000000000000000000000000
0000000000000000000000000000000000001717171E1D1C1717170000000000000000000000000000000000000000000000
0000000000000000000000000000000000000000000000000000000000000000000000000000000000000000000000000000
0000000000000000000000000000000000000000000000000000000000000000000000000000000000000000000000000000
0000000000000000000000000000000000000000000000000000000000000000000000000000000000000000000000000000
0000000000000000000000000000000000000000000000000000000000000000000000000000000000000000000000000000
0000000000000000000000000000000000000000000000000000000000000000000000000000000000000000000000000000
0000000000000000000000000000000000000000000000000000000000000000000000000000000000000000000000000000
0000000000000000000000000000000000000000000000000000000000000000000000000000000000000000000000000000
0000000000000000000000000000000000000000000000000000000000000000000000000000000000000000000000000000
0000000000000000000000000000000000000000000000000000000000000000000000000000000000000000000000000000
0000000000000000000000000000000000000000000000000000000000000000000000000000000000000000000000000000
0000000000000000000000000000000000000000000000000000000000000000000000000000000000000000000000000000
0000000000000000000000000000000505050000000000000000000000000000000000000000000000000000000000000000
0000000000000000000000000000060000000000000000000000000000000000000000000000000000000000000000000000
0000000000000000000000000000060000000000000000000000000000000000000000000000000000000000000000000000
0000000000000000000000000000000000000000000000000000000000000000000000000000000000000000000000000000
0000000000000000000000000000000000000000000000000000000000000000000000000000000000000000000000000000
0000000000000000000000080808080000000000000000000000000000000000000000000000000000000000000000000000
0000000000000000000000070000000000000000000000000000000000000000000000000000000000000000000000000000
0000000000000000000000000000000000000000000000000300000000000000000000000000000000000000000000000000
0000000000000000000000000000000000000000000000000000000000000000000000000000000000000000000000000000
0000000000000000000000000000000000000000000000000000000000000000000000000000000000000000000000000000
0000000000000000000000000000000000000000000000000400000000000000000000000000000000000000000000000000
0000000000000000000000000000000000000000000000000000000000000000000000000000000000000000000000000000
0000000000000000000000000000000000000000000000000000000000000000000000000000000000000000000000000000
0000000000000000000000000000000000000000000000000900000000000000000000000000000000000000000000000000
0000000000000000000000000000000000000000000000000000000000000000000000000000000000000000000000000000
0000000000000000000000000000000000000000000000000000000000000000000000000000000000000000000000000000
0000000000000000000000000000000000000000000000000000000000000000000001020202000000000000000000000000
0000000000000000000000000000000000000000000000000000000000000000000000000202000000000000000000000000
0000000000000000000000000000000000000000000000000000000000000000000000000000000000000000000000000000
0000000000000000000000000000000000000000000000000000000000000000000000000000000000000000000000000000
0000000000000000000000000000000000000000000000000000000000000000000000000000000000000000000000000000
0000000000000000000000000000000000000000000000000000000000000000000000000000000000000000000000000000
0000000000000000000000000000000000000000000000000000000000000000000000000000000000000000000000000000
0000000000000000000000000000000000000000000000000000000000000000000000000000000000000000000000000000
0000000000000000000000000000000000000000000000000000000000000000000000000000000000000000000000000000
0000000000000000000000000000000000000000000000000000000000000000000000000000000000000000000000000000
0000000000000000000000000000000000000000000000000000000000000000000000000000000000000000000000000000
0000000000000000000000000000000000000000000000000000000000000000000000000000000000000000000000000000
0000000000000000000000000000000000000000000000000000000000000000000000000000000000000000000000000000
0000000000000000000000000000000000000000000000000000000000000000000000000000000000000000000000000000
0000000000000000000000000000000000000000000000000000000000000000000000000000000000000000000000000000
0000000000000000000000000000000000000000000000000000000000000000000000000000000000000000000000000000
0000000000000000000000000000000000000000000000000000000000000000000000000000000000000000000000000000
0000000000000000000000000000000000000000000000000000000000000000000000000000000000000000000000000000
0000000000000000000000000000000000000000000000000000000000000000000000000000000000000000000000000000
0000000000000000000000000000000000000000000000000000000000000000000000000000000000000000000000000000
0000000000000000000000000000000000000000000000000000000000000000000000000000000000000000000000000000
0000000000000000000000000000000000000000000000000000000000000000000000000000000000000000000000000000
0000000000000000000000000000000000000000000000000000000000000000000000000000000000000000000000000000
0000000000000000000000000000000000000000000000000000000000000000000000000000000000000000000000000000
0000000000000000000000000000000000000000000000000000000000000000000000000000000000000000000000000000
0000000000000000000000000000000000000000000000000000000000000000000000000000000000000000000000000000
0000000000000000000000000000000000000000000000000000000000000000000000000000000000000000000000000000
0000000000000000000000000000000000000000000000000000000000000000000000000000000000000000000000000000
0000000000000000000000000000000000000000000000000000000000000000000000000000000000000000000000000000
