25250000
000000001A1A1A1A1A1A1A1A1A1A1A1A1A1A1A1B1A1A1A1A1A1A1A1B1A1A1B1A1A1B1A1A1A
000000001A1A0000001A0000001A0000001A830000791AA31A800000801A0000000000751A
25252525251A0000A31AD3D3D31AD3D3D31AC300000000001B71008C001A83008C0083831B
25000000251A1A1B1A1A1A1B1A1A1A1B1A1A00001A1B1A001AB0000000A30000C30000001A
26008C00500000000000000000000000005100001BA3000051000020001A1A411A1A00A31B
25000000251A1A1B1A1A1A1B1A1A1A1B1A1A00001A0000001BB0008C000000778C1A001A1A
25252525251A0000A31AD3D3D31AD3D3D31AC300B00077831A80790000000000000000801A
000000001A1A1A1A1A1A1A1A1A1A1A1A1A1A1A1B1A1A1A1A1A1A1A1B1A1AA300002000001B
000000001A1A1B1A1B1A1A1010101010102C101010102C1010101010101A00008C2000001A
000000001A76787478761A10790000008C000080107A00008900C074101A0000000000B01A
000000001AC3A0A0A0C31A10000010C08C0000004100000000001313101A511B1A1A1B411A
000000001A1A1A1A1A1A1A10000010008C0000B04100000000000013101A00008383007A1A
000000001A00000000001A2CA1A12C8C8C8C000010008CB021210000101B0000000000001B
000000001A00007700001A10000010008C0000B05100000021210000101A838CA1A18C831A
000000002300002000000051007410200020008010000000000000002C1B0000000000001B
000000001A00000000001A101010101010101010101080000000A070101A8000000000801A
000000001A1A1A511A1A1A107483838310303131321000002000A380101A1A1A310000311A
000000001A83830000891A1000830000000000A2001000008C0010101010101A310000311A
000000001B78000000001B2C00838C000000008C002C0000000010710080101A31C3C3311A
000000001A00C0C000001A100000000010890000A3100000000010008C00101A740000311A
000000001B00008C00001B10434343511010105010108300D20010770080101A310000311A
000000001A001A1A1A001A10B00000B07010800080108300000010101010101A310000311A
000000001BA3007800001B1000000000001000010010830000001414101A1A1A310000311A
000000001A008C0075831A2C00008C00002C102C102C00008C007914101AB041A20000801A
000000001A8900A383831A10000000000010102C1010000033333333101A411A00008C001A
000000001A1A511A1A1A1A1013000000001089008900000033050505101B7700000000001B
000000001AC38CC31A7E001077A18C000051C3008C0000003305C1A3101A7400000083C31A
000000001A7700001A741A101313000078108900000000003305A375101A80C3000083831A
000000001B8000001B1A1A1010101010101010101010101010101010101B8383008C00791B
000000001A2100001A1A1A1A1A1A1A1B1B1A1A1A1A1B1A1A1B1A1A1B1A1A1A1A1A0000801A
000000001BB08C791BA3C0B0A31A303131321A8000768083A2838000C1800000000000001A
000000001A0000211A1A1A1A1A1A0000797A41A3000000000020000000000033333333331B
000000001B7000801B0000000000000000891A00002000000079000074200033050505051A
000000001A2100001A008C000000008C000051008C200000008C000074208C3305D0A0B01A
000000001BD08C001B00001A1A1A1A1A00001A0000000000002000000000003305A0797A1B
000000001A8000B05100891AC0B0C01A777541A300778083A2838000C180003305B075711A
000000001A1A1A1A1A1A1A1A1A1A1A1A1A1A1A1A1A1B1A1A1B1A1A1B1A1A1B1A1A1B1A1A1A
00000000000000000000000000000000000000000000000000000000000000000000000000
00000000000000000000000000000000000000000000000000000000000000000000000000
00000000000000000000000000000000000000000000000000000000000000000000000000
00000000000013131300111111000F0F0F0000000000000000000000000000000000000000
15000000001400000012000000100000000000000000000000000000000000000000000000
00000000000013131300111111000F0F0F0000000000000000000000000000000000000000
00000000000000000000000000000000000000000000000000000000000000000000000000
00000000000000000000000000000000000000000000000000000000000000000000000000
00000000000000000000000000000000000000000000000000000000000000000000000000
00000000000000000000000000000000000000000000000000000000000000000000000000
00000000000000000000000000000000000000000000000000000000000000000000000000
00000000000707070707000000000000000000000000000000000000000000000000000000
00000000000000000000000000000000000000000000000000000000000000000000000000
00000000000000000000000000000000000000000000000000000000000000000000000000
00000000180000000000000000000000000000000000000000000000000000000000000000
00000000000000080000000000000000060000000000000000000000000000000000000000
00000000000000190000000000000000000000000000000000000000000000000000000000
00000000000000000000000000000000000000000000000000000000000000000000000000
00000000000000000000000000000000000000000000000000000000000000000000000000
00000000000000000000000000000000000000000000000000000317001703030000000000
00000000000000000000000000000000000000000000000000000000000000000000000000
00000000000000000000000000000000000000000000000000000000000000000000000000
00000000000000000000000000000000000000000000000000000000000000000000000000
00000000000000000000000000000000000000000000000000000000000000000000000000
00000000000000000000000000000000000000020000000004040404000000000000000000
00000000000000000000000000000000000000000005000004000000000000000000000000
00000000000000000116160100000000000000000005000004000000000000000000000000
00000000000000000000000000000000000000000005000004000000000000000000000000
00000000000000000000000000000000000000000000000000000000000000000000000000
00000000000000000000000000000000000000000000000000000000000000000000000000
0000000000000000000000000000000000000000000000000000000D000000000000000000
0000000000000000000909090900000000000000000000000000000D0000000E0E0E0E0E00
000000000000000000000000000A000000000000000000000000000D0000000E0000000000
000000000000000000000000000A0000000C0000000000000000000D0000000E0000000000
0000000000000000000000000B0B0B0000000000000000000000000D0000000E0000000000
0000000000000000000000000000000000000000000000000000000D0000000E0000000000
00000000000000000000000000000000000000000000000000000000000000000000000000
