112E0000
000000000000000000000000000000001A1A1A000000000000000000000000000000000000000000000000000000
000000000000000000000000000000001A831A000000000000000000000000000000000000000000000000000000
0000001A1A1A1A1B1A1A00000000001A1A721A000000000000000000000000000000000000000000000000000000
0000001A801A0000001A1A1A1A1A1A1A00001A1A1A1A000000000000000000000000000000000000000000000000
0000001A0000008C0000540000005000000053008C1A000000000000000000000000000000000000000000000000
1A1A1A1A001A0000001A1A1A00001A1A1A1A1A1A171A000000000000000000000000000000000000000000000000
1A0200008C1A1A1B1A1A001A1A001A000000001B001B000000000000000000000000001A1A252525262525251A1A
1A1A1A1A1A1A1A00000000001A231A000000001AA01A000000000000000000000000001A8000000000000000801A
000000000000000000000000000000000000001A001A000000000000000000000000001A00000000000000000025
00000000000000000000000000000000001A1A1A541A1A0000000000000000000000001A00008800000088000025
00000000000000000000000000000000001A330075001A1A1A1A1A1A1B1A1A1A1B1A1A1A00000000000000000025
00000000000000000000000000000000001B33008C0000770052000000008C000017C354000000008C0000000026
00000000000000000000000000000000001A330000001A1A1A1A1A1A1B1A1A1A1B1A1A1A00000000000000000025
00000000000000000000000000000000001A1A3333331A0000000000000000000000001A00008800000088000025
0000000000000000000000000000000000001A1A1B1A1A0000000000000000000000001A00000000000000000025
00000000000000000000000000000000000000000000000000000000000000000000001A8000000000000000801A
00000000000000000000000000000000000000000000000000000000000000000000001A1A252525262525251A1A
00000000000000000000000000000000000000000000000000000000000000000000000000000000000000000000
00000000000000000000000000000000000000000000000000000000000000000000000000000000000000000000
00000000000000000000000000000000000700000000000000000000000000000000000000000000000000000000
00000000000000080000000000000000191900000000000000000000000000000000000000000000000000000000
0000000000161508000311180017041A001912000000000000000000000000000000000000000000000000000000
00000000000000080000000017170000000000000A00000000000000000000000000000000000000000000000000
00000000010000000000000000050000000000000000000000000000000000000000000000000000100000000000
00000000000000000000000000140000000000000000000000000000000000000000000000000000000000000000
00000000000000000000000000000000000000000900000000000000000000000000000000000000000000000000
0000000000000000000000000000000000000000000000000000000000000000000000000E0E0000000000000000
00000000000000000000000000000000000000000B000000000000000000000000000000000E0000000000000000
00000000000000000000000000000000000000000000000C000D00000000000000130206000E0000000000000010
000000000000000000000000000000000000000000000000000000000000000000000000000E0000000000000000
0000000000000000000000000000000000000000000000000000000000000000000000000E0E0000000000000000
00000000000000000000000000000000000000000000000000000000000000000000000000000000000000000000
00000000000000000000000000000000000000000000000000000000000000000000000000000000000000000000
00000000000000000000000000000000000000000000000000000000000000000000000000000000100000000000
