3B0F0000
151515252526252515151500000000
151515252500252515151500000000
151515257500762515151500000000
151515250000002515151500000000
151515162550251615151500000000
153280000000000080301500000000
153100000000000000311500000000
153100000000000000311500000000
163100A0201F20A200311600000000
1531000000A2000000311500000000
153100000000000000311500000000
153080000000000080321500000000
151515151554151515151500000000
158083000000000083801500000000
158300000000000000831500000000
15000000A276A200A2001500000000
151851174217421842171500000000
150000000074000000001500000000
160000000000000000001600000000
1500A200A200A20000001500000000
151742184217421751181500000000
150000000000000000001500000000
158300000000000000831500000000
158083000000000083801500000000
151515151554151515151500000000
151580000000008383151500000000
151500000000000083151515151515
151500007621740083151500008915
151500A21F1F1FA200160000701515
151500000021000083151500008915
151500000000000083151515151515
151580000000008383151500000000
151515161554151615151500000000
151313130000000000301500000000
151313141400000000311500000000
151A1A1A1A1B1A0000311500000000
153283831A1A000000311500000000
153183838300A20000311600000000
1531830000A2000083311500000000
163100000000838383311500000000
15310000001A1A8383321500000000
153100001A1B1A1A1A1A1500000000
153100000000131314141500000000
153080000000761414141500000000
151515151554151515151500000000
151514140000000080151500000000
151513131300000000151500000000
15151A1A1A1A1A0000151500000000
15151A1A1A1A1BA200161500000000
15158383831A1A0000151500000000
151583830000000000151500000000
151583830000000000151500000000
151515151554151515151500000000
151514140000001313151500000000
151513130000001313151500000000
151513000001000014151500000000
151514000000000014151500000000
151514000000000013151500000000
151515151E1D1C1515151500000000
000000000001000000000000000000
000000000000000000000000000000
000000000000000000000000000000
000000000000000000000000000000
000000000000000000000000000000
000000000000000000000000000000
000000000000000000000000000000
000000000000000000000000000000
000000000000000000000000000000
000000000000000000000000000000
000000000000000000000000000000
000000000000000000000000000000
000000000000000000000000000000
000000000000000000000000000000
000000000000000000000000000000
000000000000000000000000000000
000000000000000000000000000000
000000000000000000000000000000
000000000000000000000000000000
000000000000000000000000000000
000000000000000000000000000000
000000000000000000000000000000
000000000000000000000000000000
000000000000000000000000000000
000000000000000000000000000000
000000000000000000000000000000
000000000000000000000000000000
000000000000000000000000000000
000000000000000000020300000000
000000000000000000000000000000
000000000000000000000000000000
000000000000000000000000000000
000000000000000000000000000000
000000000000000000000000000000
000000000000000000000000000000
000000000000000000000000000000
000000000000000000000000000000
000000000000000000000000000000
000000000000000000000000000000
000000000000000000000000000000
000000000000000000000000000000
000000000000000000000000000000
000000000000000000000000000000
000000000000000000000000000000
000000000000000000000000000000
000000000000000000000000000000
000000000000000000000000000000
000000000000000000000000000000
000000000000000000000000000000
000000000000000000000000000000
000000000000000000000000000000
000000000000000000000000000000
000000000000000000000000000000
000000000000000000000000000000
000000000000000000000000000000
000000000000000000000000000000
000000000000000000000000000000
000000000000000000000000000000
000000000000000000000000000000
