1B220000
00151010101010101010101010101010101010101010101010101010101010101010
00153031313131313131321A30313131313131313131313131313131313131313110
00150000701313141400001A00001413000075141414001376001313000077143110
00150000131414141300001A00141414130000141414001313001300001414143110
00150000A10000000000801E8000000000000000A100000000000000A30000143110
00163838383838383838381D38383838383838383838383838383838383814143110
00150000000000000000801C80000000000000000000000000000000000000143110
00150000333333333300001A00A01817174317181719171817511717180000003110
15150000330505053300005200001786000000170000001700001313171300003110
168500003305C0053300001A00001700A10000510000005300000013171300133110
12000000330505053300001A001318728C000017A200A01700008C00181414133110
11000000333333333300001B14141800000083178C008C1774000000171400133110
16850000000000000000001A0014178300838317000000172200001F177600133110
15150000000000000000891A00801783838383181750171822860020171300003110
00150000131300A02122211A13001817171917188000801817174317170000003110
0015001313140000217D211A00000000000000000000000000000000000000003110
00150000000000002121211A00000000000000000000000000000000000000003110
00151515511515151515151A1B1A1A1A1A1A1A000000000000000000131400003110
00158000000080151515151A0000001A231A1A1A1B541B1A1A000000000014003110
00150000000000001515151A0021001A001A1A21000000001A000000000000003110
001500008C0000008715151A7420000000001A00008C000041000100000000003110
001500A100B000001515151A002100A18C005400000000001A000000000000003110
00158000000080151515151A0000000000001A00860022221A1B12111B1A32313110
00151515001515151515151A1B1A1A1A1A1A1A1A1A1A1A1A1A101010101010101010
00000015501500000000000000000000000000000000000000000000000000000000
00000025002500000000000000000000000000000000000000000000000000000000
00000025262500000000000000000000000000000000000000000000000000000000
00000000000000000000000000000000000000000000000000000000000000000000
00000000000000000000000000000000000000000000000000000000000000000000
00000000000000000000000000000000000000000000000000000000000000000000
00000000000000000000000000000000000000000000000000000000000000000000
00000000000000000000000000000000000000000000000000000000000000000000
00000000000000000000000000000000000000000000000000000000000000000000
00000000000000000000000000000000000000000000000000000000000000000000
00000000000000000000000000000000000000000000000000000000000000000000
00000000000000000000000000000000000000000000000000000000000000000000
00000000000000000000000000000000000000000000000300000000000000000000
00000000000000000000000000000000000000000000000000000000000000000000
00000000000000000000000000000000000000000000000000000000000000000000
00000000000000000000000000000000000000000000000000000000000000000000
00000000000000000000000000000000000000000001000000000000000000000000
00000000000000000005000000000000000000000000000000000000000000000000
00000000000000000006000000000000000000000000000000000000000000000000
00000000000000000000000000000000000000000000000000000000000000000000
00000000000000000000000000000000000000000000000000000000000000000000
00000000000000000000000000000000020000000000000000000000000000000000
00000000000000000000000000000000000000000000000000000000000000000000
00000000000000000000000000000000000000000000000000000000000000000000
00000000000000000000000000000000000000000000000000000000000000000000
00000000000000000000000000000000000000000000000000000000000000000000
00000000000000000000000000000000000000000000000000000000000000000000
00000000000000000000000000000000000000000000000000000000000000000000
00000000000000000000000000000000000000000000000000000000000000000000
00000000040000000000000000000000000000000000000000000000000000000000
