1E320000
1010101010101010101010101010101010101010101010101010101010101010101010101010101010101010101010101010
1010101010101010101515151515151510101010101010101010101010101010101010101010101010101010101010101010
1010101010101010101589767576891510101010101010101010101010101010101010101010101010101010101010101010
1010101010101010101500787878001510101010151515151510101010101010101010101010101010101010101010101010
10101010101010101015C2A2A2A2C21510101010158900891510101010101010101010101010101010101010101010101010
10101010101010151515151515151515151510101579757A1510101010101010101010101010101010151515151515151010
1010101010101015838300000000008383151010150000001510101515151516151515151010101010158914148389151010
1010101010101015830000000000000083151010151500151510101500000000000000151010101010150000000083151010
10252525252510150000160000001600001515151515161515151515008900A3008900151515151515150000160000151010
1025000000251515000000000000A300001589141300A30013148915000000000000001580000000801500000000B3151510
1025000200005000000000A381000000005200008C0000008C0000540000007B007800520000B300005200007800A3721610
1025000000251515000000000000A300001589000000A30000008915000000000000001580131414801500000000B3151510
10252525252510150000160000001600001515151515151515151515008900A3008900151515151515150000160000151010
1010101010101015830000000000000083151015781510157615101500000000000000151010101010150000000083151010
1010101010101015838300000000008383151015151510151515101515151516151515151010101010158983838389151010
1010101010101015151515155315151515151010101010101010101010101010101010101010101010151515151515151010
1010101010101010101015800080151010101010151515151510101010101010101010101010101010101010101010101010
1010101010101015151515000000151515151010158983891510101010101515151615151516151515101010101010101010
1010101010101015131300000000000013151010158378001510101010101583830000000000838315101010101010101010
1010101010101016007800A070A0007400161010150000001510101010101583A00000000000A18315101010101010101010
1010101010101015140000000000001314151010151554151515151515151600008100B30081000016102525252510101010
1010101010101015151515140000151515151010150000001589838383891500000000000000000015152500002510101010
101010101010101010101513008315101010101016008C00540000B30000520000B2008C00B0000000500000002610101010
1010101010101010101015800080151010101010150000001589007800891500000000000000000015152500002510101010
1010101010101010101015155215151515151515151552151515151515151600008100B10081000016102525252510101010
1010101010101010101015000000000000000000000000001510101010101583A30000000000A28315101010101010101010
101010101010101010101600A300008C00B3008C0000A3001610101010101583830000000000838315101010101010101010
1010101010101010101015000000838313131314140000001510101010101515151615151516151515101010101010101010
1010101010101010101015151615151515151515151516151510101010101010101010101010101010101010101010101010
1010101010101010101010101010101010101010101010101010101010101010101010101010101010101010101010101010
0000000000000000000000000000000000000000000000000000000000000000000000000000000000000000000000000000
0000000000000000000000000000000000000000000000000000000000000000000000000000000000000000000000000000
0000000000000000000000000000000000000000000000000000000000000000000000000000000000000000000000000000
0000000000000000000000000000000000000000000000000000000000000000000000000000000000000000000000000000
0000000000000000000000000000000000000000000000000000000000000000000000000000000000000000000000000000
0000000000000000000001010101010000000000000000000000000000000000000000000000000000000000000000000000
0000000000000000000000000000000000000000000000000000000000000000000000000000000000000000000000000000
0000000000000000000000000000000000000000000004000000000000000000000000000000000000000000000000000000
0000000000000000000000000000000000000000000003000000000000000000000000000000000000000000000000000000
0000000000000000000000000000000000000000000000000000000000000000000000000000000000000000000000000000
0000000000000000000000000000000000000000000000000000000000000005000000000000000000000000000000000000
0000000000000000000000000000000000000000000000000000000000000000000000000000000000000000000000000000
0000000000000000000000000000000000000000010000000100000000000000000000000000000000000000000000000000
0000000000000000000000000000000000000000000000000000000000000000000000000000000000000000000000000000
0000000000000000000000000000000000000000000000000000000000000000000000000000000000000000000000000000
0000000000000000000000000200000000000000000000000000000000000000000000000000000000000000000000000000
0000000000000000000000000000000000000000000000000000000000000000000000000000000000000000000000000000
0000000000000000000000000000000000000000000000000000000000000000000000000000000000000000000000000000
0000000000000000000000000000000000000000000000000000000000000000000000000000000000000000000000000000
0000000000000000000000000000000000000000000000000000000000000000000000000000000000000000000000000000
0000000000000000000000000000000000000000000000000000000000000000000000000000000000000000000000000000
0000000000000000000000000000000000000000000000000000000000000000000000000000000000000000000000000000
0000000000000000000000000000000000000000000000000000000000000000000000000000000000000000000600000000
0000000000000000000000000000000000000000000000000000000000000000000000000000000000000000000000000000
0000000000000000000000000000000000000000000000000000000000000000000000000000000000000000000000000000
0000000000000000000000000000000000000000000000000000000000000000000000000000000000000000000000000000
0000000000000000000000000000000000000000000000000000000000000000000000000000000000000000000000000000
0000000000000000000000000000000000000000000000000000000000000000000000000000000000000000000000000000
0000000000000000000000000000000000000000000000000000000000000000000000000000000000000000000000000000
0000000000000000000000000000000000000000000000000000000000000000000000000000000000000000000000000000
