25360001
0000000000000000000000000000000000001A1A2020201A1B1A00000000001A1B1A1B1A1B1A1A1515161515151C1D1E150000000000
0000000000000000000000000000171717171A837900B300881A1A1B1B1B1A1A88B1791377005174000000C300003800150000000000
0000000000171717191717171817177479171A8300B300007A1A89A27CA2891A7A000000A1001A15C379770000003800150000000000
0000000000171477798017000000000070181B00C100D1C10051B2B2B2B2B25100A1D10000001B151516151515003800150000000000
0000000000171300000051A200A2000080171A0000007A00001A77797579771A00007100B1001A1A1A1A151515003800151515151515
0000000000171400C2001700007779C2000051A2771B221B001A1A00A2001A1A001B221B00001B7A771A15813300380015C2A2B27A15
0000000000171300000017431717181718171A00A222740000771A1A1A1A1A7900007422C2002275791A15813300380015C2A2B27A15
0000000000171400000000B11700000000001B00001B0000A10000007A000000A100001B00001B1A1A1A15813300387415C2A2B27A15
0000000000171700190000741900000000001A7900000000000500C200C2000500000000007A1A000000151515003800151515151515
0000000000178800C20000801700000000001A1A1B1A1B1A1A331A0000001A331A1A1B1A1B1A1A000000000016003800160000000000
0000000000170000001717171700000000000000000000001A813305000533811A000000000000000000001515003800151500000000
000000000017A000001700000000000000000000000000001A1A1A1A511A1A1A1A000000000000000000151589003800891515151500
00000000001979A07719000000000000000000000000000000001A8800881A0000000000000000000000151379A138A1771374791500
00000000001780008017000000000000000000000000000000001A0000001A0000000000000000000000151379A138A1771471791500
171717171717175117171717000000000000000000000000001A1AA100001A1A00000000000000000000151314003875831377771500
177AB2A0C017747777000017171717171717171700000000001A89008C00891A00000000000000000000151514843883831515151500
1775B2A0C01779730000A2000017A0C00533891700000000001B000000A1001B00000000000000000015151515155115151500000000
177AB2A0C0177900000000000017A0C00533891700000000001A77000000771A0000000000000000001583837A000000831500000000
171717171717000000141400C317A0C00533891700000000001A13C200C2141A00000000000000000016790000D072007A1600000000
0000000000170000A2797500771717181718171817171700001A1A1B511B1A1A000000000000000000157900000000D0771500000000
0000000017171717000000007718830000000000718017001A1A88000000881A1A000000000000000015155115333333151500000000
00000000177979170000C300771700A3000019000014171A1A770000000000791A1A0000000000000015880000797077881500000000
0000000017777719000079000051000074C143A30014171A0000000000000000001A15151516151615150000B200B200001600000000
00000000177A7A171717177788170000194319000088171A80001B0003001B00801A1588770000008315830000007400831500000000
000000001717171700001717171800C1000000A30000005100000000000000000051C0000000008C8315151516155115151500000000
00000000000000000000000000178300000000007A88171A807400000000007A801A15887700A2000014740000000000001515150000
00000000000000000000000000171718171817181717171A1A1A1A1A531A1A1A1A1A1515151500000014130000C300000000B1160000
000000000000000000000000000000000000000000000000001A80000000801A000000000016008C00A200008C0013B1000077150000
000000000000000000000000000000000000000000000000001B00D08CD0001B00000000001580790000000000791374007815150000
000000000000000000000000000000000000000000000000001A88001A00881A00000000001515161515161515161516151515000000
00000000000000000000000000000000000000000000001A1A1A1A531A531A1A1A1A0000000000000000000000000000000000000000
00000000000000000000000000000000000000000000001A8933057700770533891A0000000000000000000000000000000000000000
00000000000000000000000000000000000000000000001A8933057900790533891A0000000000000000000000000000000000000000
00000000000000000000000000000000000000000000001A1A1A25255025251A1A1A0000000000000000000000000000000000000000
000000000000000000000000000000000000000000000000000025797079250000000000000000000000000000000000000000000000
000000000000000000000000000000000000000000000000000025777577250000000000000000000000000000000000000000000000
000000000000000000000000000000000000000000000000000025252625250000000000000000000000000000000000000000000000
000000000000000000000000000000000000000000000000000000000000000000000000000000000000000000000000000000000000
000000000000000000000000000000000000000000000000000000000000000000000000000000000000000000000000000000000000
000000000000000000000000000000000000000000000000000000000000000000000000000000000000000000000000000000000000
000000000000000000000000000000000000000000000000000000000000000000000000000000000000000000000000000000000000
000000000000000000000000000000000000000000000000000000000000000000000000000000000000000000000000000000000000
0000000000000000000000000000000000000000000000000000000000000000000000000000000B0B00000000000000090000000000
00000000000000000000000000000000000000000000000000000000000000000000000000000A0B0B00000000000000090000000000
000000000000000000000000000000000000000000000000000000000000000000000000000000000000000000000000090000000000
000000000000000000000000000000000000000000000000000000000000000000000000000000000000000000080808000000000000
000000000000000000000000000000000000000000000000000000000000000000000000000000000000000000000000000000000000
000000000000000000000000000000000000000000000000000000000000000000000000000000000000000000000000000000000000
000000000000000000000000000000000000000000000000000000000000000000000000000000000000000000000000000000000000
000000000000000000000000000000000000000000000000000000000000000000000000000000000000000000000000000007070000
000000000000000000000000000000000000000000000000000000000000000000000000000000000000000000000000000607070000
000000000000000000000000000000000000000000000000000000000000000000000000000000000000000000000000000007070000
00000000000F0000000E0000000000000000000000000000000000000000000000000000000000000000000000000000000000000000
00000000000F0000000E0000000F00000000000000000000000000000000000000000000000000000000000000000000000000000000
00000000000F0000000E0000000F00000000000000000000000000000000000000000000000000000000000000000000000000000000
0000000000000E0E0E000000000F00000000000000000000000000000000000000000000000000000000000000000000000000000000
000000000000000000000000000000000000000000000000000000000000000000000000000000000000000000000000000000000000
000000000000000000000000000000000000000000000000000000000000000000000000000000000000000000050505000000000000
00000000000D0D0000000000000000000000000000000000000000000000000000000000000000000000000000040404000000000000
00000000000D0D0C00000000000000000000000000000000000000000000000000000000000000000000000000000000000000000000
00000000000D0D0000000000000000000000000000000000000000000000000000000000000000000000000000000000000000000000
000000000000000000000000000000000000000000000000000000000000000000000000000000000000000000000000000000000000
000000000000000000000000000000000000000000000000000000000000000000000000000000000000000000000000000000000000
000000000000000000000000000000000000000000000000000000000100000000000000000000000000000000000000000000000000
000000000000000000000000000000000000000000000000000000000000000000000000000000000000000000000000000000000000
000000000000000000000000000000000000000000000000000000000000000000000000000000000000000000000000000000000000
000000000000000000000000000000000000000000000000000000000000000000000000000000000000000000000000000000000000
000000000000000000000000000000000000000000000000000000020003000000000000000000000000000000000000000000000000
000000000000000000000000000000000000000000000000000000000000000000000000000000000000000000000000000000000000
000000000000000000000000000000000000000000000000000000000000000000000000000000000000000000000000000000000000
000000000000000000000000000000000000000000000000000000000000000000000000000000000000000000000000000000000000
000000000000000000000000000000000000000000000000000000000000000000000000000000000000000000000000000000000000
000000000000000000000000000000000000000000000000000000000000000000000000000000000000000000000000000000000000
000000000000000000000000000000000000000000000000000000001000000000000000000000000000000000000000000000000000
